GISJOIN,AREANAME,PopTotal,White,NonWhite,WhiteNative,Black,MedHouseValue,MedGrossRent
G17003100001,STCTY-17031 TRACT-    0001     IN CHICAGO IL,"4606","4600","6","3784","4","5630",45.65
G17003100002,STCTY-17031 TRACT-    0002     IN CHICAGO IL,"1619","1617","2","1317","2","0",57.49
G17003100003,STCTY-17031 TRACT-    0003     IN CHICAGO IL,"7391","7370","21","6128","21","6971",51.52
G17003100004,STCTY-17031 TRACT-    0004     IN CHICAGO IL,"8901","8867","34","7554","19","4922",50.81
G17003100005,STCTY-17031 TRACT-    0005     IN CHICAGO IL,"16447","16392","55","13531","39","5978",51.07
G17003100006,STCTY-17031 TRACT-    0006     IN CHICAGO IL,"7859","7846","13","6780","12","5229",53
G17003100007,STCTY-17031 TRACT-    0007     IN CHICAGO IL,"5716","5694","22","5024","13","11277",54.66
G17003100008,STCTY-17031 TRACT-    0008     IN CHICAGO IL,"8026","7984","42","6833","20","0",45.3
G17003100009,STCTY-17031 TRACT-    0009     IN CHICAGO IL,"12139","12113","26","10094","16","5979",58.29
G17003100010,STCTY-17031 TRACT-    0010     IN CHICAGO IL,"4018","3991","27","3364","27","7600",61.65
G17003100011,STCTY-17031 TRACT-    0011     IN CHICAGO IL,"6305","6275","30","5435","20","4930",58.63
G17003100012,STCTY-17031 TRACT-    0012     IN CHICAGO IL,"7337","7318","19","6272","13","7118",56.97
G17003100013,STCTY-17031 TRACT-    0013     IN CHICAGO IL,"3586","3585","1","3070","1","4697",55.65
G17003100014,STCTY-17031 TRACT-    0014     IN CHICAGO IL,"3942","3928","14","3479","11","9591",67.96
G17003100015,STCTY-17031 TRACT-    0015     IN CHICAGO IL,"2858","2841","17","2444","17","6667",63.32
G17003100016,STCTY-17031 TRACT-    0016     IN CHICAGO IL,"1190","1188","2","1016","2","7552",55.19
G17003100017,STCTY-17031 TRACT-    0017     IN CHICAGO IL,"2178","2174","4","1899","4","6708",64.84
G17003100018,STCTY-17031 TRACT-    0018     IN CHICAGO IL,"3647","3646","1","3144","1","0",45.95
G17003100019,STCTY-17031 TRACT-    0019     IN CHICAGO IL,"2123","2086","37","1861","3","0",31.45
G17003100020,STCTY-17031 TRACT-    0020     IN CHICAGO IL,"11074","11026","48","9210","24","0",35.27
G17003100021,STCTY-17031 TRACT-    0021     IN CHICAGO IL,"3227","3198","29","2661","27","0",60.73
G17003100022,STCTY-17031 TRACT-    0022     IN CHICAGO IL,"11058","11030","28","9321","14","4850",38.51
G17003100023,STCTY-17031 TRACT-    0023     IN CHICAGO IL,"5775","5444","331","4490","268","0",25.81
G17003100024,STCTY-17031 TRACT-    0024     IN CHICAGO IL,"11288","11184","104","9420","39","0",35.26
G17003100025,STCTY-17031 TRACT-    0025     IN CHICAGO IL,"0","0","0","0","0","0",0
G17003100026,STCTY-17031 TRACT-    0026     IN CHICAGO IL,"7266","7256","10","5605","2","3529",44.55
G17003100027,STCTY-17031 TRACT-    0027     IN CHICAGO IL,"7928","7885","43","6313","32","0",33.86
G17003100028,STCTY-17031 TRACT-    0028     IN CHICAGO IL,"6051","6028","23","4647","14","0",53.92
G17003100029,STCTY-17031 TRACT-    0029     IN CHICAGO IL,"2472","2469","3","2131","1","0",42.87
G17003100030,STCTY-17031 TRACT-    0030     IN CHICAGO IL,"5768","5767","1","4284","1","3567",44.57
G17003100031,STCTY-17031 TRACT-    0031     IN CHICAGO IL,"4635","4632","3","3408","0","3452",45.1
G17003100032,STCTY-17031 TRACT-    0032     IN CHICAGO IL,"3194","3194","0","2508","0","4405",43.19
G17003100033,STCTY-17031 TRACT-    0033     IN CHICAGO IL,"2994","2993","1","2514","1","4586",45.6
G17003100034,STCTY-17031 TRACT-    0034     IN CHICAGO IL,"7334","7320","14","5788","12","4870",50.65
G17003100035,STCTY-17031 TRACT-    0035     IN CHICAGO IL,"8681","8662","19","7256","16","0",49.09
G17003100036,STCTY-17031 TRACT-    0036     IN CHICAGO IL,"9555","9530","25","7695","20","3858",47.79
G17003100037,STCTY-17031 TRACT-    0037     IN CHICAGO IL,"4786","4752","34","4129","33","0",46.5
G17003100038,STCTY-17031 TRACT-    0038     IN CHICAGO IL,"8863","8851","12","7433","6","5739",53.22
G17003100039,STCTY-17031 TRACT-    0039     IN CHICAGO IL,"5461","5430","31","4785","23","0",49.3
G17003100040,STCTY-17031 TRACT-    0040     IN CHICAGO IL,"2796","2795","1","2375","1","3955",45.53
G17003100041,STCTY-17031 TRACT-    0041     IN CHICAGO IL,"3050","3049","1","2569","1","4393",41
G17003100042,STCTY-17031 TRACT-    0042     IN CHICAGO IL,"2474","2474","0","2139","0","0",43.89
G17003100043,STCTY-17031 TRACT-    0043     IN CHICAGO IL,"5085","5073","12","4083","6","4179",44.67
G17003100044,STCTY-17031 TRACT-    0044     IN CHICAGO IL,"4270","4269","1","3464","0","3718",40.88
G17003100045,STCTY-17031 TRACT-    0045     IN CHICAGO IL,"1633","1629","4","1379","0","0",43.52
G17003100046,STCTY-17031 TRACT-    0046     IN CHICAGO IL,"11757","11754","3","9620","2","3937",44.72
G17003100047,STCTY-17031 TRACT-    0047     IN CHICAGO IL,"10195","10176","19","7980","7","4495",47.57
G17003100048,STCTY-17031 TRACT-    0048     IN CHICAGO IL,"1221","1221","0","1029","0","5871",61.8
G17003100049,STCTY-17031 TRACT-    0049     IN CHICAGO IL,"4632","4631","1","3685","1","3697",42.96
G17003100050,STCTY-17031 TRACT-    0050     IN CHICAGO IL,"66","66","0","44","0","0",0
G17003100051,STCTY-17031 TRACT-    0051     IN CHICAGO IL,"3616","3616","0","2815","0","3379",37.38
G17003100052,STCTY-17031 TRACT-    0052     IN CHICAGO IL,"3731","3730","1","3002","0","3474",41.04
G17003100053,STCTY-17031 TRACT-    0053     IN CHICAGO IL,"6799","6799","0","5235","0","3112",36.15
G17003100054,STCTY-17031 TRACT-    0054     IN CHICAGO IL,"8007","8002","5","6151","1","3564",42.17
G17003100055,STCTY-17031 TRACT-    0055     IN CHICAGO IL,"3092","3088","4","2372","2","3408",41.7
G17003100056,STCTY-17031 TRACT-    0056     IN CHICAGO IL,"2022","2021","1","1551","1","2750",30.34
G17003100057,STCTY-17031 TRACT-    0057     IN CHICAGO IL,"1731","1731","0","1267","0","3632",37.79
G17003100058,STCTY-17031 TRACT-    0058     IN CHICAGO IL,"912","912","0","740","0","5514",45.65
G17003100059,STCTY-17031 TRACT-    0059     IN CHICAGO IL,"2153","2153","0","1685","0","1869",28.24
G17003100060,STCTY-17031 TRACT-    0060     IN CHICAGO IL,"4314","4308","6","3465","0","2506",23.33
G17003100061,STCTY-17031 TRACT-    0061     IN CHICAGO IL,"3258","3244","14","2552","14","3040",32.79
G17003100062,STCTY-17031 TRACT-    0062     IN CHICAGO IL,"1904","1904","0","1429","0","2336",32.91
G17003100063,STCTY-17031 TRACT-    0063     IN CHICAGO IL,"2298","2297","1","1688","1","2332",28.44
G17003100064,STCTY-17031 TRACT-    0064     IN CHICAGO IL,"2491","2491","0","1905","0","1875",31.43
G17003100065,STCTY-17031 TRACT-    0065     IN CHICAGO IL,"2431","2430","1","1814","0","3353",40.23
G17003100066,STCTY-17031 TRACT-    0066     IN CHICAGO IL,"4045","4045","0","3295","0","4840",45.32
G17003100067,STCTY-17031 TRACT-    0067     IN CHICAGO IL,"3232","3230","2","2702","2","4870",44.54
G17003100068,STCTY-17031 TRACT-    0068     IN CHICAGO IL,"4566","4554","12","3516","3","2949",35.95
G17003100069,STCTY-17031 TRACT-    0069     IN CHICAGO IL,"4584","4581","3","3508","0","2913",39.16
G17003100070,STCTY-17031 TRACT-    0070     IN CHICAGO IL,"2285","2283","2","1806","0","3313",43.53
G17003100071,STCTY-17031 TRACT-    0071     IN CHICAGO IL,"2095","2095","0","1651","0","2900",36.54
G17003100072,STCTY-17031 TRACT-    0072     IN CHICAGO IL,"2260","2244","16","1766","16","2667",31.92
G17003100073,STCTY-17031 TRACT-    0073     IN CHICAGO IL,"4107","4107","0","3208","0","2214",29.48
G17003100074,STCTY-17031 TRACT-    0074     IN CHICAGO IL,"4944","4929","15","3657","0","1982",28.91
G17003100075,STCTY-17031 TRACT-    0075     IN CHICAGO IL,"2273","2268","5","1786","3","2779",32.34
G17003100076,STCTY-17031 TRACT-    0076     IN CHICAGO IL,"2378","2378","0","1785","0","2214",30.6
G17003100077,STCTY-17031 TRACT-    0077     IN CHICAGO IL,"2279","2279","0","1680","0","1842",27.51
G17003100078,STCTY-17031 TRACT-    0078     IN CHICAGO IL,"3689","3650","39","2756","4","0",37.22
G17003100079,STCTY-17031 TRACT-    0079     IN CHICAGO IL,"5827","5799","28","4841","21","0",59.5
G17003100080,STCTY-17031 TRACT-    0080     IN CHICAGO IL,"6019","6012","7","4307","6","2583",32.46
G17003100081,STCTY-17031 TRACT-    0081     IN CHICAGO IL,"5923","5914","9","4361","4","3176",38.92
G17003100082,STCTY-17031 TRACT-    0082     IN CHICAGO IL,"3456","3447","9","2590","0","0",42.14
G17003100083,STCTY-17031 TRACT-    0083     IN CHICAGO IL,"3800","3756","44","3072","44","0",68.76
G17003100084,STCTY-17031 TRACT-    0084     IN CHICAGO IL,"3862","3861","1","2544","1","3028",30.93
G17003100085,STCTY-17031 TRACT-    0085     IN CHICAGO IL,"4968","4890","78","3112","6","2581",35.51
G17003100086,STCTY-17031 TRACT-    0086     IN CHICAGO IL,"4862","4839","23","3484","14","0",45.47
G17003100087,STCTY-17031 TRACT-    0087     IN CHICAGO IL,"6501","6449","52","5211","50","0",63.5
G17003100088,STCTY-17031 TRACT-    0088     IN CHICAGO IL,"3012","3009","3","2216","1","3236",45.55
G17003100089,STCTY-17031 TRACT-    0089     IN CHICAGO IL,"937","936","1","687","0","0",38.35
G17003100090,STCTY-17031 TRACT-    0090     IN CHICAGO IL,"2035","2029","6","1446","0","0",35.95
G17003100091,STCTY-17031 TRACT-    0091     IN CHICAGO IL,"1940","1934","6","1415","1","0",44.28
G17003100092,STCTY-17031 TRACT-    0092     IN CHICAGO IL,"6700","6656","44","5198","40","0",53.34
G17003100093,STCTY-17031 TRACT-    0093     IN CHICAGO IL,"3315","3315","0","2446","0","3199",43.4
G17003100094,STCTY-17031 TRACT-    0094     IN CHICAGO IL,"2220","2213","7","1623","1","0",37.66
G17003100095,STCTY-17031 TRACT-    0095     IN CHICAGO IL,"2913","2904","9","2171","2","0",41.85
G17003100096,STCTY-17031 TRACT-    0096     IN CHICAGO IL,"1373","1371","2","1018","0","0",34.94
G17003100097,STCTY-17031 TRACT-    0097     IN CHICAGO IL,"2037","2031","6","1658","3","0",36.93
G17003100098,STCTY-17031 TRACT-    0098     IN CHICAGO IL,"3687","3673","14","3050","4","0",30.63
G17003100099,STCTY-17031 TRACT-    0099     IN CHICAGO IL,"3331","3302","29","2723","8","0",48.09
G17003100100,STCTY-17031 TRACT-    0100     IN CHICAGO IL,"4738","4730","8","3673","0","1770",22.32
G17003100101,STCTY-17031 TRACT-    0101     IN CHICAGO IL,"3535","3535","0","2686","0","1658",24.66
G17003100102,STCTY-17031 TRACT-    0102     IN CHICAGO IL,"3890","3888","2","3062","0","1967",28.06
G17003100103,STCTY-17031 TRACT-    0103     IN CHICAGO IL,"2520","2515","5","1829","5","1363",21.26
G17003100104,STCTY-17031 TRACT-    0104     IN CHICAGO IL,"2587","2587","0","1926","0","1685",26.13
G17003100105,STCTY-17031 TRACT-    0105     IN CHICAGO IL,"6641","6639","2","4731","0","2475",29.77
G17003100106,STCTY-17031 TRACT-    0106     IN CHICAGO IL,"5569","5560","9","3956","1","2288",26.48
G17003100107,STCTY-17031 TRACT-    0107     IN CHICAGO IL,"5252","5247","5","3860","1","4520",29.79
G17003100108,STCTY-17031 TRACT-    0108     IN CHICAGO IL,"7006","6973","33","5420","18","5806",33.19
G17003100109,STCTY-17031 TRACT-    0109     IN CHICAGO IL,"5508","5469","39","4513","17","0",46.48
G17003100110,STCTY-17031 TRACT-    0110     IN CHICAGO IL,"5225","5198","27","3996","23","2558",29.8
G17003100111,STCTY-17031 TRACT-    0111     IN CHICAGO IL,"5129","5105","24","3814","2","2157",32.41
G17003100112,STCTY-17031 TRACT-    0112     IN CHICAGO IL,"6897","6884","13","5442","3","3208",36.66
G17003100113,STCTY-17031 TRACT-    0113     IN CHICAGO IL,"8913","8861","52","7405","45","0",53.56
G17003100114,STCTY-17031 TRACT-    0114     IN CHICAGO IL,"1598","1584","14","1171","14","0",23.36
G17003100115,STCTY-17031 TRACT-    0115     IN CHICAGO IL,"6234","6234","0","4160","0","1610",24.99
G17003100116,STCTY-17031 TRACT-    0116     IN CHICAGO IL,"6209","6209","0","4233","0","2155",26.96
G17003100117,STCTY-17031 TRACT-    0117     IN CHICAGO IL,"3531","3526","5","2528","0","2684",25.7
G17003100118,STCTY-17031 TRACT-    0118     IN CHICAGO IL,"2682","2680","2","1869","0","1841",26.14
G17003100119,STCTY-17031 TRACT-    0119     IN CHICAGO IL,"7162","7140","22","5249","3","3176",28.07
G17003100120,STCTY-17031 TRACT-    0120     IN CHICAGO IL,"314","313","1","201","0","0",0
G17003100121,STCTY-17031 TRACT-    0121     IN CHICAGO IL,"4842","4622","220","3391","218","1838",20.55
G17003100122,STCTY-17031 TRACT-    0122     IN CHICAGO IL,"6286","6017","269","4629","269","2385",27.04
G17003100123,STCTY-17031 TRACT-    0123     IN CHICAGO IL,"6499","6131","368","4656","310","2365",25.11
G17003100124,STCTY-17031 TRACT-    0124     IN CHICAGO IL,"7823","7741","82","6262","35","0",42.77
G17003100125,STCTY-17031 TRACT-    0125     IN CHICAGO IL,"4043","3971","72","3207","66","20000",98.52
G17003100126,STCTY-17031 TRACT-    0126     IN CHICAGO IL,"707","514","193","386","193","0",24.31
G17003100127,STCTY-17031 TRACT-    0127     IN CHICAGO IL,"5552","3742","1810","2568","1799","2250",19.95
G17003100128,STCTY-17031 TRACT-    0128     IN CHICAGO IL,"2613","1669","944","1138","797","0",23.65
G17003100129,STCTY-17031 TRACT-    0129     IN CHICAGO IL,"7614","7412","202","5967","24","0",35.45
G17003100130,STCTY-17031 TRACT-    0130     IN CHICAGO IL,"3512","3481","31","2975","3","0",52.6
G17003100131,STCTY-17031 TRACT-    0131     IN CHICAGO IL,"5789","5702","87","4775","46","0",65.97
G17003100132,STCTY-17031 TRACT-    0132     IN CHICAGO IL,"6656","6578","78","5686","56","0",88.56
G17003100133,STCTY-17031 TRACT-    0133     IN CHICAGO IL,"2333","1827","506","1293","506","0",19.27
G17003100134,STCTY-17031 TRACT-    0134     IN CHICAGO IL,"2171","1444","727","881","723","0",18.71
G17003100135,STCTY-17031 TRACT-    0135     IN CHICAGO IL,"4916","4720","196","3362","38","0",28.83
G17003100136,STCTY-17031 TRACT-    0136     IN CHICAGO IL,"2627","2535","92","2019","22","0",15.35
G17003100137,STCTY-17031 TRACT-    0137     IN CHICAGO IL,"2657","2584","73","2179","53","0",53.68
G17003100138,STCTY-17031 TRACT-    0138     IN CHICAGO IL,"105","105","0","95","0","0",0
G17003100139,STCTY-17031 TRACT-    0139     IN CHICAGO IL,"5050","5048","2","4605","0","7019",53.23
G17003100140,STCTY-17031 TRACT-    0140     IN CHICAGO IL,"844","844","0","743","0","6268",0
G17003100141,STCTY-17031 TRACT-    0141     IN CHICAGO IL,"237","237","0","204","0","0",0
G17003100142,STCTY-17031 TRACT-    0142     IN CHICAGO IL,"1018","1018","0","899","0","3440",0
G17003100143,STCTY-17031 TRACT-    0143     IN CHICAGO IL,"3701","3700","1","3181","1","6500",51.32
G17003100144,STCTY-17031 TRACT-    0144     IN CHICAGO IL,"5086","5082","4","4373","2","5830",44.66
G17003100145,STCTY-17031 TRACT-    0145     IN CHICAGO IL,"2412","2409","3","1957","1","3844",32.47
G17003100146,STCTY-17031 TRACT-    0146     IN CHICAGO IL,"4012","4012","0","3432","0","5485",47.01
G17003100147,STCTY-17031 TRACT-    0147     IN CHICAGO IL,"2683","2683","0","2178","0","3680",34.08
G17003100148,STCTY-17031 TRACT-    0148     IN CHICAGO IL,"2376","2375","1","2029","0","4256",41.69
G17003100149,STCTY-17031 TRACT-    0149     IN CHICAGO IL,"3165","3165","0","2583","0","5072",45.35
G17003100150,STCTY-17031 TRACT-    0150     IN CHICAGO IL,"8711","8698","13","6941","6","4595",39.68
G17003100151,STCTY-17031 TRACT-    0151     IN CHICAGO IL,"4602","4602","0","3869","0","5423",43.35
G17003100152,STCTY-17031 TRACT-    0152     IN CHICAGO IL,"1031","1029","2","920","2","10610",0
G17003100153,STCTY-17031 TRACT-    0153     IN CHICAGO IL,"2833","2831","2","2279","1","5548",36.35
G17003100154,STCTY-17031 TRACT-    0154     IN CHICAGO IL,"885","885","0","776","0","9771",0
G17003100155,STCTY-17031 TRACT-    0155     IN CHICAGO IL,"1881","1871","10","1697","10","13225",0
G17003100156,STCTY-17031 TRACT-    0156     IN CHICAGO IL,"921","912","9","711","9","4150",34.29
G17003100157,STCTY-17031 TRACT-    0157     IN CHICAGO IL,"6158","6153","5","4499","5","6323",52.17
G17003100158,STCTY-17031 TRACT-    0158     IN CHICAGO IL,"251","251","0","190","0","0",0
G17003100159,STCTY-17031 TRACT-    0159     IN CHICAGO IL,"4941","4806","135","3841","135","7400",58.87
G17003100160,STCTY-17031 TRACT-    0160     IN CHICAGO IL,"6988","6981","7","5631","5","5750",45.71
G17003100161,STCTY-17031 TRACT-    0161     IN CHICAGO IL,"4002","3988","14","3106","11","3950",41.16
G17003100162,STCTY-17031 TRACT-    0162     IN CHICAGO IL,"8880","8867","13","5989","7","3918",46.05
G17003100163,STCTY-17031 TRACT-    0163     IN CHICAGO IL,"9361","9344","17","6259","8","3674",44.39
G17003100164,STCTY-17031 TRACT-    0164     IN CHICAGO IL,"8612","8601","11","6443","5","6105",45.33
G17003100165,STCTY-17031 TRACT-    0165     IN CHICAGO IL,"7553","7542","11","5025","8","5537",47.87
G17003100166,STCTY-17031 TRACT-    0166     IN CHICAGO IL,"6796","6775","21","4441","9","5129",44.04
G17003100167,STCTY-17031 TRACT-    0167     IN CHICAGO IL,"4500","4495","5","2819","3","3905",45.11
G17003100168,STCTY-17031 TRACT-    0168     IN CHICAGO IL,"6072","6070","2","4820","2","3812",37
G17003100169,STCTY-17031 TRACT-    0169     IN CHICAGO IL,"7966","7960","6","6414","0","5564",45.43
G17003100170,STCTY-17031 TRACT-    0170     IN CHICAGO IL,"7829","7828","1","6634","0","5597",47.73
G17003100171,STCTY-17031 TRACT-    0171     IN CHICAGO IL,"4405","4400","5","3366","5","4874",42.14
G17003100172,STCTY-17031 TRACT-    0172     IN CHICAGO IL,"5012","5009","3","4065","0","4889",45.83
G17003100173,STCTY-17031 TRACT-    0173     IN CHICAGO IL,"5546","5546","0","4476","0","4362",42.78
G17003100174,STCTY-17031 TRACT-    0174     IN CHICAGO IL,"10248","10247","1","8627","1","4982",42.73
G17003100175,STCTY-17031 TRACT-    0175     IN CHICAGO IL,"708","708","0","592","0","0",40.82
G17003100176,STCTY-17031 TRACT-    0176     IN CHICAGO IL,"1997","1997","0","1575","0","5400",37.61
G17003100177,STCTY-17031 TRACT-    0177     IN CHICAGO IL,"3470","3465","5","2840","0","5518",46.53
G17003100178,STCTY-17031 TRACT-    0178     IN CHICAGO IL,"5343","5343","0","4290","0","5463",45.41
G17003100179,STCTY-17031 TRACT-    0179     IN CHICAGO IL,"7761","7757","4","6197","0","4269",42.54
G17003100180,STCTY-17031 TRACT-    0180     IN CHICAGO IL,"4969","4965","4","4154","3","4486",39.04
G17003100181,STCTY-17031 TRACT-    0181     IN CHICAGO IL,"3865","3862","3","3173","0","4665",41.61
G17003100182,STCTY-17031 TRACT-    0182     IN CHICAGO IL,"2414","2413","1","2036","1","5614",43.57
G17003100183,STCTY-17031 TRACT-    0183     IN CHICAGO IL,"3999","3999","0","3480","0","4541",44.03
G17003100184,STCTY-17031 TRACT-    0184     IN CHICAGO IL,"2897","2892","5","2538","0","4745",44.13
G17003100185,STCTY-17031 TRACT-    0185     IN CHICAGO IL,"4248","4244","4","3600","0","5572",44.68
G17003100186,STCTY-17031 TRACT-    0186     IN CHICAGO IL,"6534","6533","1","5244","0","3616",40.7
G17003100187,STCTY-17031 TRACT-    0187     IN CHICAGO IL,"6706","6704","2","5331","1","3433",40.42
G17003100188,STCTY-17031 TRACT-    0188     IN CHICAGO IL,"6071","6071","0","4872","0","4267",40.89
G17003100189,STCTY-17031 TRACT-    0189     IN CHICAGO IL,"8449","8442","7","6500","0","3119",41.52
G17003100190,STCTY-17031 TRACT-    0190     IN CHICAGO IL,"8477","8470","7","6650","7","3831",43.14
G17003100191,STCTY-17031 TRACT-    0191     IN CHICAGO IL,"2624","2623","1","2118","1","3206",37.57
G17003100192,STCTY-17031 TRACT-    0192     IN CHICAGO IL,"5300","5291","9","4376","1","3891",40.57
G17003100193,STCTY-17031 TRACT-    0193     IN CHICAGO IL,"1380","1380","0","1040","0","3188",0
G17003100194,STCTY-17031 TRACT-    0194     IN CHICAGO IL,"2539","2536","3","2067","0","3329",33.03
G17003100195,STCTY-17031 TRACT-    0195     IN CHICAGO IL,"775","775","0","620","0","2821",0
G17003100196,STCTY-17031 TRACT-    0196     IN CHICAGO IL,"1649","1649","0","1322","0","2571",22.93
G17003100197,STCTY-17031 TRACT-    0197     IN CHICAGO IL,"2038","2026","12","1609","4","3228",32.26
G17003100198,STCTY-17031 TRACT-    0198     IN CHICAGO IL,"756","756","0","618","0","3142",0
G17003100199,STCTY-17031 TRACT-    0199     IN CHICAGO IL,"3588","3588","0","2844","0","3965",39.55
G17003100200,STCTY-17031 TRACT-    0200     IN CHICAGO IL,"3800","3799","1","3167","1","5819",46.48
G17003100201,STCTY-17031 TRACT-    0201     IN CHICAGO IL,"3618","3616","2","2922","1","5169",39.55
G17003100202,STCTY-17031 TRACT-    0202     IN CHICAGO IL,"3185","3181","4","2612","0","5494",44.4
G17003100203,STCTY-17031 TRACT-    0203     IN CHICAGO IL,"3568","3568","0","2724","0","5314",40.19
G17003100204,STCTY-17031 TRACT-    0204     IN CHICAGO IL,"5093","5091","2","4006","2","4368",40.01
G17003100205,STCTY-17031 TRACT-    0205     IN CHICAGO IL,"1032","1027","5","908","0","0",45.28
G17003100206,STCTY-17031 TRACT-    0206     IN CHICAGO IL,"1115","1115","0","841","0","4389",43.18
G17003100207,STCTY-17031 TRACT-    0207     IN CHICAGO IL,"7014","7014","0","5790","0","6069",46.61
G17003100208,STCTY-17031 TRACT-    0208     IN CHICAGO IL,"5211","5211","0","4287","0","6500",45.16
G17003100209,STCTY-17031 TRACT-    0209     IN CHICAGO IL,"5167","5163","4","4140","1","5438",46.79
G17003100210,STCTY-17031 TRACT-    0210     IN CHICAGO IL,"1985","1984","1","1601","0","4967",46.98
G17003100211,STCTY-17031 TRACT-    0211     IN CHICAGO IL,"0","0","0","0","0","0",0
G17003100212,STCTY-17031 TRACT-    0212     IN CHICAGO IL,"7027","7026","1","5371","1","4194",40.09
G17003100213,STCTY-17031 TRACT-    0213     IN CHICAGO IL,"6841","6840","1","5149","1","3581",41.05
G17003100214,STCTY-17031 TRACT-    0214     IN CHICAGO IL,"5956","5947","9","4776","0","5254",44.79
G17003100215,STCTY-17031 TRACT-    0215     IN CHICAGO IL,"1754","1754","0","1434","0","5549",45.65
G17003100216,STCTY-17031 TRACT-    0216     IN CHICAGO IL,"730","730","0","567","0","3419",0
G17003100217,STCTY-17031 TRACT-    0217     IN CHICAGO IL,"7715","7714","1","5539","0","3163",30.65
G17003100218,STCTY-17031 TRACT-    0218     IN CHICAGO IL,"3590","3590","0","2732","0","3107",28.7
G17003100219,STCTY-17031 TRACT-    0219     IN CHICAGO IL,"6913","6910","3","5326","1","3714",39.55
G17003100220,STCTY-17031 TRACT-    0220     IN CHICAGO IL,"2284","2284","0","1818","0","4078",37.64
G17003100221,STCTY-17031 TRACT-    0221     IN CHICAGO IL,"3661","3661","0","2979","0","6265",45.34
G17003100222,STCTY-17031 TRACT-    0222     IN CHICAGO IL,"4621","4617","4","3661","0","4396",44.18
G17003100223,STCTY-17031 TRACT-    0223     IN CHICAGO IL,"1948","1947","1","1522","0","3421",39.74
G17003100224,STCTY-17031 TRACT-    0224     IN CHICAGO IL,"7500","7500","0","5812","0","3173",36.46
G17003100225,STCTY-17031 TRACT-    0225     IN CHICAGO IL,"4343","4341","2","3436","0","2476",33.79
G17003100226,STCTY-17031 TRACT-    0226     IN CHICAGO IL,"821","821","0","643","0","0",36.59
G17003100227,STCTY-17031 TRACT-    0227     IN CHICAGO IL,"4352","4352","0","3587","0","2561",33.42
G17003100228,STCTY-17031 TRACT-    0228     IN CHICAGO IL,"7659","7659","0","6143","0","3360",40.84
G17003100229,STCTY-17031 TRACT-    0229     IN CHICAGO IL,"1827","1827","0","1452","0","2558",31.53
G17003100230,STCTY-17031 TRACT-    0230     IN CHICAGO IL,"2833","2827","6","2250","6","4632",45.27
G17003100231,STCTY-17031 TRACT-    0231     IN CHICAGO IL,"9628","9627","1","7595","0","2566",33.5
G17003100232,STCTY-17031 TRACT-    0232     IN CHICAGO IL,"9128","9112","16","7237","4","2347",33.3
G17003100233,STCTY-17031 TRACT-    0233     IN CHICAGO IL,"6243","6242","1","4978","1","2784",36.31
G17003100234,STCTY-17031 TRACT-    0234     IN CHICAGO IL,"1877","1875","2","1511","1","3859",34.87
G17003100235,STCTY-17031 TRACT-    0235     IN CHICAGO IL,"4137","4135","2","3225","0","3112",31.75
G17003100236,STCTY-17031 TRACT-    0236     IN CHICAGO IL,"131","131","0","101","0","0",0
G17003100237,STCTY-17031 TRACT-    0237     IN CHICAGO IL,"8839","8831","8","6685","1","2799",37.45
G17003100238,STCTY-17031 TRACT-    0238     IN CHICAGO IL,"10172","10160","12","7977","1","3427",39.54
G17003100239,STCTY-17031 TRACT-    0239     IN CHICAGO IL,"4067","4064","3","3158","1","3612",43.64
G17003100240,STCTY-17031 TRACT-    0240     IN CHICAGO IL,"4145","4142","3","3156","2","3516",41.8
G17003100241,STCTY-17031 TRACT-    0241     IN CHICAGO IL,"3897","3896","1","3122","1","3207",38.2
G17003100242,STCTY-17031 TRACT-    0242     IN CHICAGO IL,"3148","3148","0","2491","0","2364",29.71
G17003100243,STCTY-17031 TRACT-    0243     IN CHICAGO IL,"1536","1536","0","1221","0","2407",27.46
G17003100244,STCTY-17031 TRACT-    0244     IN CHICAGO IL,"4495","4486","9","3328","5","2434",36.55
G17003100245,STCTY-17031 TRACT-    0245     IN CHICAGO IL,"4171","4171","0","3281","0","1953",28.87
G17003100246,STCTY-17031 TRACT-    0246     IN CHICAGO IL,"4401","4400","1","3478","0","2667",32.33
G17003100247,STCTY-17031 TRACT-    0247     IN CHICAGO IL,"6050","6049","1","4637","0","1996",26.31
G17003100248,STCTY-17031 TRACT-    0248     IN CHICAGO IL,"5892","5891","1","4475","0","1835",22.19
G17003100249,STCTY-17031 TRACT-    0249     IN CHICAGO IL,"7171","7165","6","5455","4","3104",37.64
G17003100250,STCTY-17031 TRACT-    0250     IN CHICAGO IL,"3594","3591","3","2637","2","2300",35.95
G17003100251,STCTY-17031 TRACT-    0251     IN CHICAGO IL,"1325","1325","0","1030","0","2414",31.28
G17003100252,STCTY-17031 TRACT-    0252     IN CHICAGO IL,"1177","1177","0","930","0","0",28.41
G17003100253,STCTY-17031 TRACT-    0253     IN CHICAGO IL,"6686","6681","5","4886","5","3176",40.07
G17003100254,STCTY-17031 TRACT-    0254     IN CHICAGO IL,"4179","4171","8","3064","5","3230",41.59
G17003100255,STCTY-17031 TRACT-    0255     IN CHICAGO IL,"2758","2757","1","2002","1","2081",29.84
G17003100256,STCTY-17031 TRACT-    0256     IN CHICAGO IL,"2725","2725","0","2018","0","1971",31.24
G17003100257,STCTY-17031 TRACT-    0257     IN CHICAGO IL,"2289","2288","1","1700","1","2027",29.78
G17003100258,STCTY-17031 TRACT-    0258     IN CHICAGO IL,"2600","2600","0","2076","0","1808",28.19
G17003100259,STCTY-17031 TRACT-    0259     IN CHICAGO IL,"1772","1772","0","1460","0","1445",25.17
G17003100260,STCTY-17031 TRACT-    0260     IN CHICAGO IL,"3385","3370","15","2620","10","1991",25.77
G17003100261,STCTY-17031 TRACT-    0261     IN CHICAGO IL,"3832","3832","0","2893","0","1954",26.44
G17003100262,STCTY-17031 TRACT-    0262     IN CHICAGO IL,"1294","1294","0","1000","0","2052",29.65
G17003100263,STCTY-17031 TRACT-    0263     IN CHICAGO IL,"2635","2635","0","2060","0","1944",24.35
G17003100264,STCTY-17031 TRACT-    0264     IN CHICAGO IL,"1644","1644","0","1304","0","1711",22.95
G17003100265,STCTY-17031 TRACT-    0265     IN CHICAGO IL,"3516","3509","7","2747","7","2348",35
G17003100266,STCTY-17031 TRACT-    0266     IN CHICAGO IL,"2697","2696","1","2068","1","3173",38.33
G17003100267,STCTY-17031 TRACT-    0267     IN CHICAGO IL,"1144","1144","0","912","0","0",28.62
G17003100268,STCTY-17031 TRACT-    0268     IN CHICAGO IL,"6765","6764","1","5143","0","3012",34.79
G17003100269,STCTY-17031 TRACT-    0269     IN CHICAGO IL,"1514","1514","0","1141","0","3286",32.86
G17003100270,STCTY-17031 TRACT-    0270     IN CHICAGO IL,"9378","9378","0","6894","0","3008",36.31
G17003100271,STCTY-17031 TRACT-    0271     IN CHICAGO IL,"1646","1646","0","1184","0","3147",34.5
G17003100272,STCTY-17031 TRACT-    0272     IN CHICAGO IL,"2830","2829","1","2181","0","2201",32.78
G17003100273,STCTY-17031 TRACT-    0273     IN CHICAGO IL,"2851","2850","1","2039","1","2111",32.48
G17003100274,STCTY-17031 TRACT-    0274     IN CHICAGO IL,"8340","8332","8","5424","7","2677",40.13
G17003100275,STCTY-17031 TRACT-    0275     IN CHICAGO IL,"4754","4749","5","3255","5","3478",38.27
G17003100276,STCTY-17031 TRACT-    0276     IN CHICAGO IL,"612","612","0","397","0","0",34.32
G17003100277,STCTY-17031 TRACT-    0277     IN CHICAGO IL,"7955","7951","4","6288","0","3074",36.62
G17003100278,STCTY-17031 TRACT-    0278     IN CHICAGO IL,"7783","7778","5","5836","5","3169",33.68
G17003100279,STCTY-17031 TRACT-    0279     IN CHICAGO IL,"0","0","0","0","0","0",0
G17003100280,STCTY-17031 TRACT-    0280     IN CHICAGO IL,"12430","12418","12","9240","6","2693",37.59
G17003100281,STCTY-17031 TRACT-    0281     IN CHICAGO IL,"3260","3260","0","2502","0","2744",38.34
G17003100282,STCTY-17031 TRACT-    0282     IN CHICAGO IL,"1854","1854","0","1474","0","2614",35.84
G17003100283,STCTY-17031 TRACT-    0283     IN CHICAGO IL,"2669","2668","1","1874","1","2056",30.64
G17003100284,STCTY-17031 TRACT-    0284     IN CHICAGO IL,"2429","2429","0","1854","0","1872",26.23
G17003100285,STCTY-17031 TRACT-    0285     IN CHICAGO IL,"3965","3954","11","2441","11","2235",34.2
G17003100286,STCTY-17031 TRACT-    0286     IN CHICAGO IL,"4715","4706","9","2979","8","1926",29.02
G17003100287,STCTY-17031 TRACT-    0287     IN CHICAGO IL,"2786","2758","28","1991","28","1895",26.82
G17003100288,STCTY-17031 TRACT-    0288     IN CHICAGO IL,"3801","3703","98","2543","98","2168",26.11
G17003100289,STCTY-17031 TRACT-    0289     IN CHICAGO IL,"4816","4745","71","3390","69","1811",22.59
G17003100290,STCTY-17031 TRACT-    0290     IN CHICAGO IL,"4758","4561","197","3235","197","1701",21.95
G17003100291,STCTY-17031 TRACT-    0291     IN CHICAGO IL,"4980","4976","4","3709","4","1454",21.6
G17003100292,STCTY-17031 TRACT-    0292     IN CHICAGO IL,"5915","5911","4","3965","3","2648",29.98
G17003100293,STCTY-17031 TRACT-    0293     IN CHICAGO IL,"6993","6993","0","4898","0","1707",24.31
G17003100294,STCTY-17031 TRACT-    0294     IN CHICAGO IL,"7017","7006","11","4936","0","1513",22.03
G17003100295,STCTY-17031 TRACT-    0295     IN CHICAGO IL,"2207","2207","0","1711","0","1369",25.63
G17003100296,STCTY-17031 TRACT-    0296     IN CHICAGO IL,"1956","1948","8","1448","0","2154",27.93
G17003100297,STCTY-17031 TRACT-    0297     IN CHICAGO IL,"142","142","0","106","0","0",0
G17003100298,STCTY-17031 TRACT-    0298     IN CHICAGO IL,"7708","7621","87","5145","82","2078",27.22
G17003100299,STCTY-17031 TRACT-    0299     IN CHICAGO IL,"5751","5670","81","3884","73","2058",29.21
G17003100300,STCTY-17031 TRACT-    0300     IN CHICAGO IL,"4201","4197","4","2804","0","2114",26.96
G17003100301,STCTY-17031 TRACT-    0301     IN CHICAGO IL,"11496","11470","26","7553","26","2070",30.98
G17003100302,STCTY-17031 TRACT-    0302     IN CHICAGO IL,"3406","3404","2","2295","2","2389",34.31
G17003100303,STCTY-17031 TRACT-    0303     IN CHICAGO IL,"5770","5750","20","3929","20","2108",29.12
G17003100304,STCTY-17031 TRACT-    0304     IN CHICAGO IL,"6453","6445","8","4334","4","3333",34.51
G17003100305,STCTY-17031 TRACT-    0305     IN CHICAGO IL,"919","918","1","718","1","0",24.72
G17003100306,STCTY-17031 TRACT-    0306     IN CHICAGO IL,"2825","2821","4","2143","0","1771",22.51
G17003100307,STCTY-17031 TRACT-    0307     IN CHICAGO IL,"2116","2111","5","1653","0","1647",22.13
G17003100308,STCTY-17031 TRACT-    0308     IN CHICAGO IL,"1383","1383","0","1132","0","0",21.9
G17003100309,STCTY-17031 TRACT-    0309     IN CHICAGO IL,"8963","8956","7","5888","5","1972",25.7
G17003100310,STCTY-17031 TRACT-    0310     IN CHICAGO IL,"5607","5607","0","4270","0","1472",21.9
G17003100311,STCTY-17031 TRACT-    0311     IN CHICAGO IL,"7374","7373","1","5570","0","1271",19.88
G17003100312,STCTY-17031 TRACT-    0312     IN CHICAGO IL,"2959","2958","1","2262","0","1019",19.09
G17003100313,STCTY-17031 TRACT-    0313     IN CHICAGO IL,"7299","7299","0","5107","0","1490",19.41
G17003100314,STCTY-17031 TRACT-    0314     IN CHICAGO IL,"4385","4382","3","3160","0","1049",18.42
G17003100315,STCTY-17031 TRACT-    0315     IN CHICAGO IL,"2158","2155","3","1502","3","0",18.39
G17003100316,STCTY-17031 TRACT-    0316     IN CHICAGO IL,"5495","5456","39","3850","39","2172",23.52
G17003100317,STCTY-17031 TRACT-    0317     IN CHICAGO IL,"6663","6656","7","4473","7","924",18.78
G17003100318,STCTY-17031 TRACT-    0318     IN CHICAGO IL,"5074","5074","0","3335","0","0",22.73
G17003100319,STCTY-17031 TRACT-    0319     IN CHICAGO IL,"2396","2381","15","1434","15","0",16.13
G17003100320,STCTY-17031 TRACT-    0320     IN CHICAGO IL,"374","373","1","269","1","0",0
G17003100321,STCTY-17031 TRACT-    0321     IN CHICAGO IL,"4263","4263","0","3684","0","8722",51.96
G17003100322,STCTY-17031 TRACT-    0322     IN CHICAGO IL,"6661","6661","0","5597","0","4864",46.09
G17003100323,STCTY-17031 TRACT-    0323     IN CHICAGO IL,"5079","5075","4","4238","0","4214",45.19
G17003100324,STCTY-17031 TRACT-    0324     IN CHICAGO IL,"2820","2820","0","2303","0","5171",40.74
G17003100325,STCTY-17031 TRACT-    0325     IN CHICAGO IL,"637","636","1","503","0","0",34.26
G17003100326,STCTY-17031 TRACT-    0326     IN CHICAGO IL,"5032","5029","3","4282","0","6243",50.58
G17003100327,STCTY-17031 TRACT-    0327     IN CHICAGO IL,"7205","7202","3","6005","0","5368",50.44
G17003100328,STCTY-17031 TRACT-    0328     IN CHICAGO IL,"3160","3156","4","2578","0","5040",46.14
G17003100329,STCTY-17031 TRACT-    0329     IN CHICAGO IL,"1026","1026","0","823","0","4121",37.45
G17003100330,STCTY-17031 TRACT-    0330     IN CHICAGO IL,"6448","6442","6","5208","0","4140",44.83
G17003100331,STCTY-17031 TRACT-    0331     IN CHICAGO IL,"5226","5225","1","4451","0","5652",45.88
G17003100332,STCTY-17031 TRACT-    0332     IN CHICAGO IL,"6217","6217","0","5184","0","3842",45.86
G17003100333,STCTY-17031 TRACT-    0333     IN CHICAGO IL,"1964","1958","6","1598","6","4155",42.89
G17003100334,STCTY-17031 TRACT-    0334     IN CHICAGO IL,"6416","6413","3","5645","0","4711",43.94
G17003100335,STCTY-17031 TRACT-    0335     IN CHICAGO IL,"5709","5702","7","4964","7","4634",44.69
G17003100336,STCTY-17031 TRACT-    0336     IN CHICAGO IL,"5658","5655","3","4602","1","3684",37.41
G17003100337,STCTY-17031 TRACT-    0337     IN CHICAGO IL,"3708","3694","14","2984","12","2926",32.91
G17003100338,STCTY-17031 TRACT-    0338     IN CHICAGO IL,"7672","7668","4","6749","3","6418",50.5
G17003100339,STCTY-17031 TRACT-    0339     IN CHICAGO IL,"8598","8587","11","7367","10","5713",47.2
G17003100340,STCTY-17031 TRACT-    0340     IN CHICAGO IL,"10841","10835","6","9397","5","3786",42.78
G17003100341,STCTY-17031 TRACT-    0341     IN CHICAGO IL,"11078","11068","10","8807","9","4948",51.76
G17003100342,STCTY-17031 TRACT-    0342     IN CHICAGO IL,"3364","3364","0","2733","0","5690",43.61
G17003100343,STCTY-17031 TRACT-    0343     IN CHICAGO IL,"11029","11012","17","9198","7","3802",44.3
G17003100344,STCTY-17031 TRACT-    0344     IN CHICAGO IL,"2296","2296","0","1848","0","3527",34.05
G17003100345,STCTY-17031 TRACT-    0345     IN CHICAGO IL,"3245","3244","1","2851","0","3122",44.28
G17003100346,STCTY-17031 TRACT-    0346     IN CHICAGO IL,"3743","3742","1","3128","1","3344",36.19
G17003100347,STCTY-17031 TRACT-    0347     IN CHICAGO IL,"3666","3660","6","3115","6","3262",37.7
G17003100348,STCTY-17031 TRACT-    0348     IN CHICAGO IL,"4450","4440","10","3453","2","3408",42.22
G17003100349,STCTY-17031 TRACT-    0349     IN CHICAGO IL,"6376","6374","2","5048","1","2956",42.05
G17003100350,STCTY-17031 TRACT-    0350     IN CHICAGO IL,"6324","6321","3","4866","0","2823",38.9
G17003100351,STCTY-17031 TRACT-    0351     IN CHICAGO IL,"3294","3287","7","2691","1","0",34.46
G17003100352,STCTY-17031 TRACT-    0352     IN CHICAGO IL,"7025","7006","19","4853","7","3474",52.33
G17003100353,STCTY-17031 TRACT-    0353     IN CHICAGO IL,"6555","6553","2","4951","2","3066",40.55
G17003100354,STCTY-17031 TRACT-    0354     IN CHICAGO IL,"3769","3765","4","2679","4","2342",42.75
G17003100355,STCTY-17031 TRACT-    0355     IN CHICAGO IL,"2193","2186","7","1828","7","2728",36.4
G17003100356,STCTY-17031 TRACT-    0356     IN CHICAGO IL,"1230","1226","4","875","1","0",41.33
G17003100357,STCTY-17031 TRACT-    0357     IN CHICAGO IL,"1769","1758","11","1480","5","0",40.66
G17003100358,STCTY-17031 TRACT-    0358     IN CHICAGO IL,"4220","4220","0","3640","0","2867",31.8
G17003100359,STCTY-17031 TRACT-    0359     IN CHICAGO IL,"4488","3743","745","3211","742","1831",27.3
G17003100360,STCTY-17031 TRACT-    0360     IN CHICAGO IL,"2371","472","1899","404","1892","0",26.86
G17003100361,STCTY-17031 TRACT-    0361     IN CHICAGO IL,"1128","815","313","719","308","0",27
G17003100362,STCTY-17031 TRACT-    0362     IN CHICAGO IL,"3170","3141","29","2663","10","1900",26.38
G17003100363,STCTY-17031 TRACT-    0363     IN CHICAGO IL,"3093","3090","3","1990","3","3620",45.47
G17003100364,STCTY-17031 TRACT-    0364     IN CHICAGO IL,"2521","2521","0","1745","0","2792",39.22
G17003100365,STCTY-17031 TRACT-    0365     IN CHICAGO IL,"3132","3130","2","2207","2","2636",39.04
G17003100366,STCTY-17031 TRACT-    0366     IN CHICAGO IL,"3848","3841","7","2756","7","2223",32.25
G17003100367,STCTY-17031 TRACT-    0367     IN CHICAGO IL,"3504","3504","0","2526","0","2102",30.57
G17003100368,STCTY-17031 TRACT-    0368     IN CHICAGO IL,"7575","7560","15","5877","5","3128",36.79
G17003100369,STCTY-17031 TRACT-    0369     IN CHICAGO IL,"4737","4732","5","3706","1","2724",34.77
G17003100370,STCTY-17031 TRACT-    0370     IN CHICAGO IL,"1675","1674","1","1462","1","0",26.39
G17003100371,STCTY-17031 TRACT-    0371     IN CHICAGO IL,"1726","1719","7","1469","0","0",23.75
G17003100372,STCTY-17031 TRACT-    0372     IN CHICAGO IL,"5469","5457","12","4498","5","1815",29.75
G17003100373,STCTY-17031 TRACT-    0373     IN CHICAGO IL,"5443","5418","25","4479","1","2250",27.83
G17003100374,STCTY-17031 TRACT-    0374     IN CHICAGO IL,"538","538","0","416","0","0",0
G17003100375,STCTY-17031 TRACT-    0375     IN CHICAGO IL,"1959","1959","0","1462","0","0",29.2
G17003100376,STCTY-17031 TRACT-    0376     IN CHICAGO IL,"1654","96","1558","80","1557","0",25.75
G17003100377,STCTY-17031 TRACT-    0377     IN CHICAGO IL,"4211","673","3538","554","3537","2145",25.71
G17003100378,STCTY-17031 TRACT-    0378     IN CHICAGO IL,"3454","906","2548","765","2501","0",22.31
G17003100379,STCTY-17031 TRACT-    0379     IN CHICAGO IL,"858","292","566","252","565","0",27.07
G17003100380,STCTY-17031 TRACT-    0380     IN CHICAGO IL,"454","198","256","157","255","0",20.19
G17003100381,STCTY-17031 TRACT-    0381     IN CHICAGO IL,"610","552","58","474","55","0",11.58
G17003100382,STCTY-17031 TRACT-    0382     IN CHICAGO IL,"3205","3139","66","2664","39","2000",26.63
G17003100383,STCTY-17031 TRACT-    0383     IN CHICAGO IL,"1762","1744","18","1515","16","0",19.25
G17003100384,STCTY-17031 TRACT-    0384     IN CHICAGO IL,"1311","1281","30","1128","23","0",21.73
G17003100385,STCTY-17031 TRACT-    0385     IN CHICAGO IL,"323","17","306","12","306","0",0
G17003100386,STCTY-17031 TRACT-    0386     IN CHICAGO IL,"502","1","501","1","501","0",26.5
G17003100387,STCTY-17031 TRACT-    0387     IN CHICAGO IL,"170","4","166","4","166","0",0
G17003100388,STCTY-17031 TRACT-    0388     IN CHICAGO IL,"1047","1021","26","853","0","0",22.65
G17003100389,STCTY-17031 TRACT-    0389     IN CHICAGO IL,"663","661","2","527","1","0",25.67
G17003100390,STCTY-17031 TRACT-    0390     IN CHICAGO IL,"3097","3096","1","2565","0","2280",23.12
G17003100391,STCTY-17031 TRACT-    0391     IN CHICAGO IL,"206","206","0","147","0","0",0
G17003100392,STCTY-17031 TRACT-    0392     IN CHICAGO IL,"2300","2300","0","1706","0","0",29.97
G17003100393,STCTY-17031 TRACT-    0393     IN CHICAGO IL,"1891","1891","0","1384","0","2285",24.44
G17003100394,STCTY-17031 TRACT-    0394     IN CHICAGO IL,"733","642","91","508","91","0",0
G17003100395,STCTY-17031 TRACT-    0395     IN CHICAGO IL,"2095","2076","19","1683","19","2034",22.71
G17003100396,STCTY-17031 TRACT-    0396     IN CHICAGO IL,"936","936","0","671","0","0",23.34
G17003100397,STCTY-17031 TRACT-    0397     IN CHICAGO IL,"4497","4102","395","2933","376","2244",26.21
G17003100398,STCTY-17031 TRACT-    0398     IN CHICAGO IL,"429","428","1","363","0","0",0
G17003100399,STCTY-17031 TRACT-    0399     IN CHICAGO IL,"583","579","4","486","3","0",23.67
G17003100400,STCTY-17031 TRACT-    0400     IN CHICAGO IL,"261","259","2","215","0","0",0
G17003100401,STCTY-17031 TRACT-    0401     IN CHICAGO IL,"2230","1961","269","1684","266","0",25.54
G17003100402,STCTY-17031 TRACT-    0402     IN CHICAGO IL,"2434","1345","1089","927","1089","0",25.28
G17003100403,STCTY-17031 TRACT-    0403     IN CHICAGO IL,"2914","2793","121","2189","119","1362",23.82
G17003100404,STCTY-17031 TRACT-    0404     IN CHICAGO IL,"453","443","10","350","0","0",0
G17003100405,STCTY-17031 TRACT-    0405     IN CHICAGO IL,"885","878","7","647","4","0",27.22
G17003100406,STCTY-17031 TRACT-    0406     IN CHICAGO IL,"404","399","5","276","5","0",0
G17003100407,STCTY-17031 TRACT-    0407     IN CHICAGO IL,"3858","3840","18","2791","1","1414",22.12
G17003100408,STCTY-17031 TRACT-    0408     IN CHICAGO IL,"1913","1908","5","1271","0","0",28.49
G17003100409,STCTY-17031 TRACT-    0409     IN CHICAGO IL,"838","838","0","618","0","0",20.66
G17003100410,STCTY-17031 TRACT-    0410     IN CHICAGO IL,"3874","3809","65","3214","7","2207",17.87
G17003100411,STCTY-17031 TRACT-    0411     IN CHICAGO IL,"917","917","0","787","0","0",15.24
G17003100412,STCTY-17031 TRACT-    0412     IN CHICAGO IL,"1360","1149","211","965","181","0",16.06
G17003100413,STCTY-17031 TRACT-    0413     IN CHICAGO IL,"4072","3888","184","3259","167","1984",18.13
G17003100414,STCTY-17031 TRACT-    0414     IN CHICAGO IL,"4652","4584","68","3769","2","0",15.27
G17003100415,STCTY-17031 TRACT-    0415     IN CHICAGO IL,"2466","2128","338","1459","325","0",10.87
G17003100416,STCTY-17031 TRACT-    0416     IN CHICAGO IL,"1771","1725","46","1048","40","0",6.08
G17003100417,STCTY-17031 TRACT-    0417     IN CHICAGO IL,"844","834","10","503","0","0",0
G17003100418,STCTY-17031 TRACT-    0418     IN CHICAGO IL,"5694","5663","31","4495","16","0",10.67
G17003100419,STCTY-17031 TRACT-    0419     IN CHICAGO IL,"3321","3289","32","2181","20","0",12.52
G17003100420,STCTY-17031 TRACT-    0420     IN CHICAGO IL,"3465","3457","8","1976","4","0",12.56
G17003100421,STCTY-17031 TRACT-    0421     IN CHICAGO IL,"3838","3830","8","2599","8","1773",22.3
G17003100422,STCTY-17031 TRACT-    0422     IN CHICAGO IL,"3549","3533","16","2180","16","0",23.04
G17003100423,STCTY-17031 TRACT-    0423     IN CHICAGO IL,"831","738","93","241","89","0",13.55
G17003100424,STCTY-17031 TRACT-    0424     IN CHICAGO IL,"51","51","0","50","0","0",0
G17003100425,STCTY-17031 TRACT-    0425     IN CHICAGO IL,"792","558","234","400","234","0",21.31
G17003100426,STCTY-17031 TRACT-    0426     IN CHICAGO IL,"853","812","41","556","41","0",19.12
G17003100427,STCTY-17031 TRACT-    0427     IN CHICAGO IL,"628","623","5","456","5","0",28.5
G17003100428,STCTY-17031 TRACT-    0428     IN CHICAGO IL,"4995","4861","134","3310","134","2108",25.47
G17003100429,STCTY-17031 TRACT-    0429     IN CHICAGO IL,"4691","4509","182","3518","162","0",24.15
G17003100430,STCTY-17031 TRACT-    0430     IN CHICAGO IL,"277","277","0","193","0","0",0
G17003100431,STCTY-17031 TRACT-    0431     IN CHICAGO IL,"2335","1710","625","1143","619","0",26.06
G17003100432,STCTY-17031 TRACT-    0432     IN CHICAGO IL,"4129","3728","401","2671","401","1375",19.25
G17003100433,STCTY-17031 TRACT-    0433     IN CHICAGO IL,"1838","1038","800","759","800","0",20.79
G17003100434,STCTY-17031 TRACT-    0434     IN CHICAGO IL,"5774","1071","4703","749","4703","0",21.51
G17003100435,STCTY-17031 TRACT-    0435     IN CHICAGO IL,"2311","2045","266","1368","259","0",22.47
G17003100436,STCTY-17031 TRACT-    0436     IN CHICAGO IL,"1856","1853","3","1247","2","0",23.82
G17003100437,STCTY-17031 TRACT-    0437     IN CHICAGO IL,"1043","1002","41","666","41","0",21.79
G17003100438,STCTY-17031 TRACT-    0438     IN CHICAGO IL,"1181","1181","0","836","0","0",24.23
G17003100439,STCTY-17031 TRACT-    0439     IN CHICAGO IL,"652","590","62","415","62","0",18.97
G17003100440,STCTY-17031 TRACT-    0440     IN CHICAGO IL,"2602","212","2390","128","2379","0",19.37
G17003100441,STCTY-17031 TRACT-    0441     IN CHICAGO IL,"4329","2296","2033","1302","2028","0",21.41
G17003100442,STCTY-17031 TRACT-    0442     IN CHICAGO IL,"2042","685","1357","396","1355","0",18.84
G17003100443,STCTY-17031 TRACT-    0443     IN CHICAGO IL,"304","123","181","91","179","0",0
G17003100444,STCTY-17031 TRACT-    0444     IN CHICAGO IL,"2840","2839","1","1851","1","2654",41.05
G17003100445,STCTY-17031 TRACT-    0445     IN CHICAGO IL,"2063","2063","0","1363","0","0",38.64
G17003100446,STCTY-17031 TRACT-    0446     IN CHICAGO IL,"1268","1265","3","728","1","0",42.98
G17003100447,STCTY-17031 TRACT-    0447     IN CHICAGO IL,"2308","2272","36","1395","33","0",41.17
G17003100448,STCTY-17031 TRACT-    0448     IN CHICAGO IL,"1361","1314","47","756","47","0",34.55
G17003100449,STCTY-17031 TRACT-    0449     IN CHICAGO IL,"1792","1792","0","1137","0","0",28.68
G17003100450,STCTY-17031 TRACT-    0450     IN CHICAGO IL,"19829","19766","63","10549","59","2044",39.64
G17003100451,STCTY-17031 TRACT-    0451     IN CHICAGO IL,"8721","8683","38","5182","24","2236",39.98
G17003100452,STCTY-17031 TRACT-    0452     IN CHICAGO IL,"8033","7956","77","4464","77","2089",34.6
G17003100453,STCTY-17031 TRACT-    0453     IN CHICAGO IL,"1746","1741","5","1047","5","0",33.6
G17003100454,STCTY-17031 TRACT-    0454     IN CHICAGO IL,"4291","4219","72","2336","65","0",34.92
G17003100455,STCTY-17031 TRACT-    0455     IN CHICAGO IL,"2802","2795","7","1732","6","0",29.5
G17003100456,STCTY-17031 TRACT-    0456     IN CHICAGO IL,"116","80","36","61","36","0",0
G17003100457,STCTY-17031 TRACT-    0457     IN CHICAGO IL,"4171","4170","1","2953","0","1857",27.26
G17003100458,STCTY-17031 TRACT-    0458     IN CHICAGO IL,"0","0","0","0","0","0",0
G17003100459,STCTY-17031 TRACT-    0459     IN CHICAGO IL,"1808","1808","0","1297","0","2022",28.08
G17003100460,STCTY-17031 TRACT-    0460     IN CHICAGO IL,"13930","13926","4","9173","2","2167",40.62
G17003100461,STCTY-17031 TRACT-    0461     IN CHICAGO IL,"3915","3905","10","2283","10","0",39.41
G17003100462,STCTY-17031 TRACT-    0462     IN CHICAGO IL,"5506","5504","2","4023","1","3544",36.31
G17003100463,STCTY-17031 TRACT-    0463     IN CHICAGO IL,"5988","5982","6","3822","4","2461",39.47
G17003100464,STCTY-17031 TRACT-    0464     IN CHICAGO IL,"2401","2395","6","1892","5","2524",33.62
G17003100465,STCTY-17031 TRACT-    0465     IN CHICAGO IL,"0","0","0","0","0","0",0
G17003100466,STCTY-17031 TRACT-    0466     IN CHICAGO IL,"1490","1490","0","1212","0","0",38.37
G17003100467,STCTY-17031 TRACT-    0467     IN CHICAGO IL,"1539","1539","0","1247","0","2702",33.47
G17003100468,STCTY-17031 TRACT-    0468     IN CHICAGO IL,"1549","1545","4","1108","4","0",29.44
G17003100469,STCTY-17031 TRACT-    0469     IN CHICAGO IL,"1793","1793","0","1164","0","2682",34.08
G17003100470,STCTY-17031 TRACT-    0470     IN CHICAGO IL,"1210","1206","4","914","0","0",34.5
G17003100471,STCTY-17031 TRACT-    0471     IN CHICAGO IL,"2437","2437","0","1854","0","1888",22.07
G17003100472,STCTY-17031 TRACT-    0472     IN CHICAGO IL,"1253","1253","0","946","0","0",23.76
G17003100473,STCTY-17031 TRACT-    0473     IN CHICAGO IL,"1496","1496","0","1173","0","2197",26.01
G17003100474,STCTY-17031 TRACT-    0474     IN CHICAGO IL,"4937","4937","0","3730","0","2101",26.14
G17003100475,STCTY-17031 TRACT-    0475     IN CHICAGO IL,"0","0","0","0","0","0",0
G17003100476,STCTY-17031 TRACT-    0476     IN CHICAGO IL,"2927","2927","0","2193","0","2753",32.67
G17003100477,STCTY-17031 TRACT-    0477     IN CHICAGO IL,"11335","11333","2","8991","0","2796",31.78
G17003100478,STCTY-17031 TRACT-    0478     IN CHICAGO IL,"7377","7372","5","5190","4","2701",28.8
G17003100479,STCTY-17031 TRACT-    0479     IN CHICAGO IL,"1301","1301","0","969","0","3450",26.43
G17003100480,STCTY-17031 TRACT-    0480     IN CHICAGO IL,"2587","2587","0","1869","0","3124",27.66
G17003100481,STCTY-17031 TRACT-    0481     IN CHICAGO IL,"3107","3106","1","2246","1","3487",33.57
G17003100482,STCTY-17031 TRACT-    0482     IN CHICAGO IL,"449","448","1","314","1","0",0
G17003100483,STCTY-17031 TRACT-    0483     IN CHICAGO IL,"4193","4189","4","3012","0","2413",30.69
G17003100484,STCTY-17031 TRACT-    0484     IN CHICAGO IL,"5051","5051","0","3618","0","2370",26.6
G17003100485,STCTY-17031 TRACT-    0485     IN CHICAGO IL,"344","344","0","275","0","0",0
G17003100486,STCTY-17031 TRACT-    0486     IN CHICAGO IL,"225","225","0","175","0","0",0
G17003100487,STCTY-17031 TRACT-    0487     IN CHICAGO IL,"1701","1698","3","1280","0","0",28.9
G17003100488,STCTY-17031 TRACT-    0488     IN CHICAGO IL,"6053","6052","1","4491","0","1913",23.58
G17003100489,STCTY-17031 TRACT-    0489     IN CHICAGO IL,"2995","2995","0","2325","0","2112",24.29
G17003100490,STCTY-17031 TRACT-    0490     IN CHICAGO IL,"4259","4259","0","2919","0","2425",28.12
G17003100491,STCTY-17031 TRACT-    0491     IN CHICAGO IL,"3251","3251","0","2324","0","2274",27.93
G17003100492,STCTY-17031 TRACT-    0492     IN CHICAGO IL,"1151","1151","0","866","0","1742",22.52
G17003100493,STCTY-17031 TRACT-    0493     IN CHICAGO IL,"2452","1660","792","1411","784","0",0
G17003100494,STCTY-17031 TRACT-    0494     IN CHICAGO IL,"34","34","0","26","0","0",0
G17003100495,STCTY-17031 TRACT-    0495     IN CHICAGO IL,"2686","2685","1","1975","1","1351",18.02
G17003100496,STCTY-17031 TRACT-    0496     IN CHICAGO IL,"8363","8362","1","5670","0","1130",19
G17003100497,STCTY-17031 TRACT-    0497     IN CHICAGO IL,"2411","2406","5","1682","0","1854",17.49
G17003100498,STCTY-17031 TRACT-    0498     IN CHICAGO IL,"19","19","0","12","0","0",0
G17003100499,STCTY-17031 TRACT-    0499     IN CHICAGO IL,"2341","2341","0","1675","0","902",16.47
G17003100500,STCTY-17031 TRACT-    0500     IN CHICAGO IL,"3191","3183","8","2326","1","1425",18.92
G17003100501,STCTY-17031 TRACT-    0501     IN CHICAGO IL,"4835","4832","3","3312","0","1350",18.36
G17003100502,STCTY-17031 TRACT-    0502     IN CHICAGO IL,"877","875","2","603","1","0",17.96
G17003100503,STCTY-17031 TRACT-    0503     IN CHICAGO IL,"19","19","0","12","0","0",0
G17003100504,STCTY-17031 TRACT-    0504     IN CHICAGO IL,"123","123","0","101","0","0",0
G17003100505,STCTY-17031 TRACT-    0505     IN CHICAGO IL,"7419","7419","0","5652","0","1684",20.54
G17003100506,STCTY-17031 TRACT-    0506     IN CHICAGO IL,"5998","5995","3","3754","3","2175",28.94
G17003100507,STCTY-17031 TRACT-    0507     IN CHICAGO IL,"473","473","0","319","0","0",0
G17003100508,STCTY-17031 TRACT-    0508     IN CHICAGO IL,"7911","7911","0","6001","0","1426",19.98
G17003100509,STCTY-17031 TRACT-    0509     IN CHICAGO IL,"7643","7639","4","5671","0","1582",19.82
G17003100510,STCTY-17031 TRACT-    0510     IN CHICAGO IL,"3599","3599","0","2566","0","1673",22.69
G17003100511,STCTY-17031 TRACT-    0511     IN CHICAGO IL,"605","594","11","509","6","0",0
G17003100512,STCTY-17031 TRACT-    0512     IN CHICAGO IL,"12","12","0","10","0","0",0
G17003100513,STCTY-17031 TRACT-    0513     IN CHICAGO IL,"448","448","0","370","0","0",0
G17003100514,STCTY-17031 TRACT-    0514     IN CHICAGO IL,"2256","2188","68","1693","7","0",0
G17003100515,STCTY-17031 TRACT-    0515     IN CHICAGO IL,"553","534","19","432","0","0",0
G17003100516,STCTY-17031 TRACT-    0516     IN CHICAGO IL,"2347","2339","8","1896","1","0",41.57
G17003100517,STCTY-17031 TRACT-    0517     IN CHICAGO IL,"3278","3139","139","2615","135","0",22.32
G17003100518,STCTY-17031 TRACT-    0518     IN CHICAGO IL,"0","0","0","0","0","0",0
G17003100519,STCTY-17031 TRACT-    0519     IN CHICAGO IL,"1366","1271","95","1018","69","0",17.99
G17003100520,STCTY-17031 TRACT-    0520     IN CHICAGO IL,"1294","790","504","654","492","0",25.22
G17003100521,STCTY-17031 TRACT-    0521     IN CHICAGO IL,"881","84","797","77","797","0",28.06
G17003100522,STCTY-17031 TRACT-    0522     IN CHICAGO IL,"487","86","401","59","397","0",14.9
G17003100523,STCTY-17031 TRACT-    0523     IN CHICAGO IL,"262","27","235","21","18","0",0
G17003100524,STCTY-17031 TRACT-    0524     IN CHICAGO IL,"5091","4287","804","3095","138","1397",22.79
G17003100525,STCTY-17031 TRACT-    0525     IN CHICAGO IL,"486","486","0","385","0","0",18.82
G17003100526,STCTY-17031 TRACT-    0526     IN CHICAGO IL,"1700","1700","0","1273","0","1558",23.39
G17003100527,STCTY-17031 TRACT-    0527     IN CHICAGO IL,"1601","1572","29","1172","29","0",24.18
G17003100528,STCTY-17031 TRACT-    0528     IN CHICAGO IL,"1033","1033","0","715","0","0",27.87
G17003100529,STCTY-17031 TRACT-    0529     IN CHICAGO IL,"205","194","11","135","10","0",0
G17003100530,STCTY-17031 TRACT-    0530     IN CHICAGO IL,"368","368","0","269","0","0",0
G17003100531,STCTY-17031 TRACT-    0531     IN CHICAGO IL,"197","197","0","133","0","0",0
G17003100532,STCTY-17031 TRACT-    0532     IN CHICAGO IL,"954","952","2","657","2","0",26.85
G17003100533,STCTY-17031 TRACT-    0533     IN CHICAGO IL,"733","579","154","393","152","0",23.25
G17003100534,STCTY-17031 TRACT-    0534     IN CHICAGO IL,"1774","1482","292","1094","292","2839",26.94
G17003100535,STCTY-17031 TRACT-    0535     IN CHICAGO IL,"1059","379","680","284","676","0",21.38
G17003100536,STCTY-17031 TRACT-    0536     IN CHICAGO IL,"377","94","283","63","283","0",0
G17003100537,STCTY-17031 TRACT-    0537     IN CHICAGO IL,"475","44","431","26","431","0",22.86
G17003100538,STCTY-17031 TRACT-    0538     IN CHICAGO IL,"2157","124","2033","92","2031","0",22.49
G17003100539,STCTY-17031 TRACT-    0539     IN CHICAGO IL,"1525","191","1334","154","1334","0",21.73
G17003100540,STCTY-17031 TRACT-    0540     IN CHICAGO IL,"385","6","379","6","379","0",25.67
G17003100541,STCTY-17031 TRACT-    0541     IN CHICAGO IL,"1766","53","1713","35","1710","0",26.98
G17003100542,STCTY-17031 TRACT-    0542     IN CHICAGO IL,"3087","45","3042","29","3039","0",23.38
G17003100543,STCTY-17031 TRACT-    0543     IN CHICAGO IL,"2958","441","2517","352","2516","0",24.06
G17003100544,STCTY-17031 TRACT-    0544     IN CHICAGO IL,"1340","32","1308","21","1304","0",21.06
G17003100545,STCTY-17031 TRACT-    0545     IN CHICAGO IL,"1412","8","1404","5","1403","0",21.15
G17003100546,STCTY-17031 TRACT-    0546     IN CHICAGO IL,"1987","64","1923","48","1921","0",19.99
G17003100547,STCTY-17031 TRACT-    0547     IN CHICAGO IL,"4235","32","4203","16","4203","0",25.83
G17003100548,STCTY-17031 TRACT-    0548     IN CHICAGO IL,"3471","614","2857","471","2856","0",22.72
G17003100549,STCTY-17031 TRACT-    0549     IN CHICAGO IL,"3660","834","2826","737","2822","0",27.23
G17003100550,STCTY-17031 TRACT-    0550     IN CHICAGO IL,"1372","19","1353","14","1346","0",17.96
G17003100551,STCTY-17031 TRACT-    0551     IN CHICAGO IL,"654","3","651","3","651","0",23.55
G17003100552,STCTY-17031 TRACT-    0552     IN CHICAGO IL,"4080","23","4057","17","4055","0",24.51
G17003100553,STCTY-17031 TRACT-    0553     IN CHICAGO IL,"5101","47","5054","33","5054","2647",25.54
G17003100554,STCTY-17031 TRACT-    0554     IN CHICAGO IL,"5283","173","5110","133","5107","0",28.38
G17003100555,STCTY-17031 TRACT-    0555     IN CHICAGO IL,"4476","664","3812","559","3810","2911",25.76
G17003100556,STCTY-17031 TRACT-    0556     IN CHICAGO IL,"1570","29","1541","18","1540","0",26.06
G17003100557,STCTY-17031 TRACT-    0557     IN CHICAGO IL,"4762","8","4754","7","4754","2583",21.83
G17003100558,STCTY-17031 TRACT-    0558     IN CHICAGO IL,"1222","1179","43","959","6","0",23.76
G17003100559,STCTY-17031 TRACT-    0559     IN CHICAGO IL,"2660","370","2290","298","2278","0",27.88
G17003100560,STCTY-17031 TRACT-    0560     IN CHICAGO IL,"3665","2834","831","2352","760","0",25.96
G17003100561,STCTY-17031 TRACT-    0561     IN CHICAGO IL,"3183","3014","169","2606","162","3024",25.48
G17003100562,STCTY-17031 TRACT-    0562     IN CHICAGO IL,"3770","3756","14","3280","3","3424",28.49
G17003100563,STCTY-17031 TRACT-    0563     IN CHICAGO IL,"668","656","12","537","0","0",22.91
G17003100564,STCTY-17031 TRACT-    0564     IN CHICAGO IL,"1647","1441","206","1110","206","1818",20.89
G17003100565,STCTY-17031 TRACT-    0565     IN CHICAGO IL,"3048","3038","10","2201","10","1661",25.33
G17003100566,STCTY-17031 TRACT-    0566     IN CHICAGO IL,"843","580","263","403","262","0",21.04
G17003100567,STCTY-17031 TRACT-    0567     IN CHICAGO IL,"3293","3114","179","2377","179","1653",25.21
G17003100568,STCTY-17031 TRACT-    0568     IN CHICAGO IL,"0","0","0","0","0","0",0
G17003100569,STCTY-17031 TRACT-    0569     IN CHICAGO IL,"3549","3533","16","2669","4","1923",24.73
G17003100570,STCTY-17031 TRACT-    0570     IN CHICAGO IL,"1078","445","633","341","632","0",27.98
G17003100571,STCTY-17031 TRACT-    0571     IN CHICAGO IL,"357","341","16","271","16","0",0
G17003100572,STCTY-17031 TRACT-    0572     IN CHICAGO IL,"611","482","129","360","129","0",22
G17003100573,STCTY-17031 TRACT-    0573     IN CHICAGO IL,"1234","23","1211","17","1211","0",27.78
G17003100574,STCTY-17031 TRACT-    0574     IN CHICAGO IL,"2925","323","2602","237","2600","0",29.31
G17003100575,STCTY-17031 TRACT-    0575     IN CHICAGO IL,"8938","284","8654","219","8651","2303",24.26
G17003100576,STCTY-17031 TRACT-    0576     IN CHICAGO IL,"5939","113","5826","93","5822","3429",24.13
G17003100577,STCTY-17031 TRACT-    0577     IN CHICAGO IL,"6389","14","6375","10","6373","3331",30.44
G17003100578,STCTY-17031 TRACT-    0578     IN CHICAGO IL,"4442","42","4400","23","4392","0",31.44
G17003100579,STCTY-17031 TRACT-    0579     IN CHICAGO IL,"1401","5","1396","3","1395","0",23.31
G17003100580,STCTY-17031 TRACT-    0580     IN CHICAGO IL,"1235","13","1222","10","1222","0",25.76
G17003100581,STCTY-17031 TRACT-    0581     IN CHICAGO IL,"5238","67","5171","59","5168","0",25.69
G17003100582,STCTY-17031 TRACT-    0582     IN CHICAGO IL,"8496","36","8460","27","8453","4067",22.17
G17003100583,STCTY-17031 TRACT-    0583     IN CHICAGO IL,"8024","48","7976","33","7971","3650",26.86
G17003100584,STCTY-17031 TRACT-    0584     IN CHICAGO IL,"5912","74","5838","43","5838","0",30.96
G17003100585,STCTY-17031 TRACT-    0585     IN CHICAGO IL,"3641","19","3622","9","3621","0",31.03
G17003100586,STCTY-17031 TRACT-    0586     IN CHICAGO IL,"8727","37","8690","19","8687","0",25.73
G17003100587,STCTY-17031 TRACT-    0587     IN CHICAGO IL,"6351","147","6204","125","6203","0",26.05
G17003100588,STCTY-17031 TRACT-    0588     IN CHICAGO IL,"1565","8","1557","3","1556","0",29.43
G17003100589,STCTY-17031 TRACT-    0589     IN CHICAGO IL,"6471","182","6289","133","6288","0",40.85
G17003100590,STCTY-17031 TRACT-    0590     IN CHICAGO IL,"2291","60","2231","43","2231","0",34.82
G17003100591,STCTY-17031 TRACT-    0591     IN CHICAGO IL,"8740","349","8391","272","8383","2833",31.86
G17003100592,STCTY-17031 TRACT-    0592     IN CHICAGO IL,"5297","20","5277","13","5274","0",26.04
G17003100593,STCTY-17031 TRACT-    0593     IN CHICAGO IL,"5059","4969","90","4083","84","0",38.1
G17003100594,STCTY-17031 TRACT-    0594     IN CHICAGO IL,"5103","5087","16","4335","12","4097",33.09
G17003100595,STCTY-17031 TRACT-    0595     IN CHICAGO IL,"4726","4714","12","4027","5","4571",33.65
G17003100596,STCTY-17031 TRACT-    0596     IN CHICAGO IL,"3962","3927","35","3144","30","0",44.15
G17003100597,STCTY-17031 TRACT-    0597     IN CHICAGO IL,"2658","2589","69","2078","64","20000",43.26
G17003100598,STCTY-17031 TRACT-    0598     IN CHICAGO IL,"3397","3336","61","2799","60","14286",54.61
G17003100599,STCTY-17031 TRACT-    0599     IN CHICAGO IL,"4706","4673","33","3966","23","0",44.68
G17003100600,STCTY-17031 TRACT-    0600     IN CHICAGO IL,"2663","11","2652","8","2652","0",27.7
G17003100601,STCTY-17031 TRACT-    0601     IN CHICAGO IL,"7266","309","6957","135","6954","0",35.38
G17003100602,STCTY-17031 TRACT-    0602     IN CHICAGO IL,"9122","189","8933","128","8931","0",34.28
G17003100603,STCTY-17031 TRACT-    0603     IN CHICAGO IL,"7061","56","7005","38","7001","3250",42.47
G17003100604,STCTY-17031 TRACT-    0604     IN CHICAGO IL,"11663","123","11540","76","11530","0",36.39
G17003100605,STCTY-17031 TRACT-    0605     IN CHICAGO IL,"4077","51","4026","28","4025","0",43.24
G17003100606,STCTY-17031 TRACT-    0606     IN CHICAGO IL,"3678","68","3610","34","3607","2533",31.29
G17003100607,STCTY-17031 TRACT-    0607     IN CHICAGO IL,"7206","623","6583","469","6581","0",41.99
G17003100608,STCTY-17031 TRACT-    0608     IN CHICAGO IL,"1043","1030","13","790","13","0",69.85
G17003100609,STCTY-17031 TRACT-    0609     IN CHICAGO IL,"1372","1361","11","1076","11","0",58.08
G17003100610,STCTY-17031 TRACT-    0610     IN CHICAGO IL,"1935","1925","10","1621","10","0",55.72
G17003100611,STCTY-17031 TRACT-    0611     IN CHICAGO IL,"2691","2674","17","2291","7","0",48.97
G17003100612,STCTY-17031 TRACT-    0612     IN CHICAGO IL,"5272","5231","41","4363","41","0",64.53
G17003100613,STCTY-17031 TRACT-    0613     IN CHICAGO IL,"5615","5501","114","4481","109","0",41.9
G17003100614,STCTY-17031 TRACT-    0614     IN CHICAGO IL,"5451","5380","71","4115","54","3864",46.39
G17003100615,STCTY-17031 TRACT-    0615     IN CHICAGO IL,"4421","4411","10","3141","5","0",49.27
G17003100616,STCTY-17031 TRACT-    0616     IN CHICAGO IL,"6082","6007","75","4340","59","0",46.16
G17003100617,STCTY-17031 TRACT-    0617     IN CHICAGO IL,"3858","3734","124","2911","54","0",44.14
G17003100618,STCTY-17031 TRACT-    0618     IN CHICAGO IL,"1218","1193","25","925","17","0",34.61
G17003100619,STCTY-17031 TRACT-    0619     IN CHICAGO IL,"3432","3364","68","2889","23","12685",44.67
G17003100620,STCTY-17031 TRACT-    0620     IN CHICAGO IL,"4275","4081","194","3502","145","0",38.61
G17003100621,STCTY-17031 TRACT-    0621     IN CHICAGO IL,"3087","3060","27","2618","25","0",71.87
G17003100622,STCTY-17031 TRACT-    0622     IN CHICAGO IL,"798","798","0","705","0","0",53.07
G17003100623,STCTY-17031 TRACT-    0623     IN CHICAGO IL,"5325","4476","849","3324","814","2602",39.84
G17003100624,STCTY-17031 TRACT-    0624     IN CHICAGO IL,"3284","3279","5","2417","3","2763",44.23
G17003100625,STCTY-17031 TRACT-    0625     IN CHICAGO IL,"9601","726","8875","593","8866","3284",39.2
G17003100626,STCTY-17031 TRACT-    0626     IN CHICAGO IL,"3143","3134","9","2590","2","0",41.42
G17003100627,STCTY-17031 TRACT-    0627     IN CHICAGO IL,"7773","7753","20","6575","9","2955",32.99
G17003100628,STCTY-17031 TRACT-    0628     IN CHICAGO IL,"4937","4924","13","4322","2","0",30.57
G17003100629,STCTY-17031 TRACT-    0629     IN CHICAGO IL,"6866","6861","5","6003","0","5268",39.79
G17003100630,STCTY-17031 TRACT-    0630     IN CHICAGO IL,"7240","7223","17","6300","2","0",31.94
G17003100631,STCTY-17031 TRACT-    0631     IN CHICAGO IL,"6683","6674","9","5999","7","4921",37.22
G17003100632,STCTY-17031 TRACT-    0632     IN CHICAGO IL,"5091","5084","7","4467","2","0",28.39
G17003100633,STCTY-17031 TRACT-    0633     IN CHICAGO IL,"9055","9016","39","7905","1","0",34.6
G17003100634,STCTY-17031 TRACT-    0634     IN CHICAGO IL,"2687","288","2399","221","0","3300",38.22
G17003100635,STCTY-17031 TRACT-    0635     IN CHICAGO IL,"8416","8374","42","7105","39","18333",49.16
G17003100636,STCTY-17031 TRACT-    0636     IN CHICAGO IL,"12599","12495","104","10569","95","11935",62.18
G17003100637,STCTY-17031 TRACT-    0637     IN CHICAGO IL,"2124","2110","14","1899","14","0",57.42
G17003100638,STCTY-17031 TRACT-    0638     IN CHICAGO IL,"2954","2941","13","2614","13","13464",52.02
G17003100639,STCTY-17031 TRACT-    0639     IN CHICAGO IL,"6298","6285","13","5549","13","5417",49.46
G17003100640,STCTY-17031 TRACT-    0640     IN CHICAGO IL,"2271","2271","0","2002","0","9444",53.02
G17003100641,STCTY-17031 TRACT-    0641     IN CHICAGO IL,"2768","2760","8","2416","8","9971",57.63
G17003100642,STCTY-17031 TRACT-    0642     IN CHICAGO IL,"19328","19265","63","16450","62","5740",53.54
G17003100643,STCTY-17031 TRACT-    0643     IN CHICAGO IL,"3729","3729","0","3235","0","7102",57.26
G17003100644,STCTY-17031 TRACT-    0644     IN CHICAGO IL,"6719","6716","3","5879","3","6384",52.38
G17003100645,STCTY-17031 TRACT-    0645     IN CHICAGO IL,"5478","5463","15","4622","2","3844",45.84
G17003100646,STCTY-17031 TRACT-    0646     IN CHICAGO IL,"4870","4869","1","4080","0","3731",43.9
G17003100647,STCTY-17031 TRACT-    0647     IN CHICAGO IL,"2039","2039","0","1569","0","2713",36.7
G17003100648,STCTY-17031 TRACT-    0648     IN CHICAGO IL,"4459","4453","6","3896","4","6313",49.85
G17003100649,STCTY-17031 TRACT-    0649     IN CHICAGO IL,"10122","10120","2","8672","2","6101",55.1
G17003100650,STCTY-17031 TRACT-    0650     IN CHICAGO IL,"9878","9871","7","8654","2","4821",52.15
G17003100651,STCTY-17031 TRACT-    0651     IN CHICAGO IL,"655","648","7","530","3","0",0
G17003100652,STCTY-17031 TRACT-    0652     IN CHICAGO IL,"2642","2642","0","2081","0","5052",42.46
G17003100653,STCTY-17031 TRACT-    0653     IN CHICAGO IL,"831","831","0","714","0","5250",0
G17003100654,STCTY-17031 TRACT-    0654     IN CHICAGO IL,"8","8","0","8","0","0",0
G17003100655,STCTY-17031 TRACT-    0655     IN CHICAGO IL,"6","6","0","5","0","0",0
G17003100656,STCTY-17031 TRACT-    0656     IN CHICAGO IL,"4476","4476","0","3770","0","5101",44.23
G17003100657,STCTY-17031 TRACT-    0657     IN CHICAGO IL,"3842","3833","9","2878","9","3803",37.6
G17003100658,STCTY-17031 TRACT-    0658     IN CHICAGO IL,"869","869","0","702","0","0",36.3
G17003100659,STCTY-17031 TRACT-    0659     IN CHICAGO IL,"4165","4161","4","3671","2","5962",49.55
G17003100660,STCTY-17031 TRACT-    0660     IN CHICAGO IL,"608","608","0","463","0","0",34.78
G17003100661,STCTY-17031 TRACT-    0661     IN CHICAGO IL,"5691","5689","2","5007","2","6619",47.37
G17003100662,STCTY-17031 TRACT-    0662     IN CHICAGO IL,"7534","7521","13","6568","8","6857",53.94
G17003100663,STCTY-17031 TRACT-    0663     IN CHICAGO IL,"4223","4214","9","3411","9","4552",54.25
G17003100664,STCTY-17031 TRACT-    0664     IN CHICAGO IL,"11868","11867","1","9517","1","3700",36.57
G17003100665,STCTY-17031 TRACT-    0665     IN CHICAGO IL,"6327","6315","12","5141","12","3280",31.57
G17003100666,STCTY-17031 TRACT-    0666     IN CHICAGO IL,"6514","6500","14","4968","0","2146",26.05
G17003100667,STCTY-17031 TRACT-    0667     IN CHICAGO IL,"5805","5672","133","4275","133","2014",26.25
G17003100668,STCTY-17031 TRACT-    0668     IN CHICAGO IL,"2391","2391","0","1945","0","3117",34.63
G17003100669,STCTY-17031 TRACT-    0669     IN CHICAGO IL,"3826","3799","27","2966","27","2568",31.79
G17003100670,STCTY-17031 TRACT-    0670     IN CHICAGO IL,"2801","2113","688","1250","686","0",25.91
G17003100671,STCTY-17031 TRACT-    0671     IN CHICAGO IL,"3801","3765","36","2662","31","0",26.29
G17003100672,STCTY-17031 TRACT-    0672     IN CHICAGO IL,"2","2","0","2","0","0",0
G17003100673,STCTY-17031 TRACT-    0673     IN CHICAGO IL,"3565","3556","9","2464","4","2735",28.91
G17003100674,STCTY-17031 TRACT-    0674     IN CHICAGO IL,"0","0","0","0","0","0",0
G17003100675,STCTY-17031 TRACT-    0675     IN CHICAGO IL,"262","262","0","220","0","0",0
G17003100676,STCTY-17031 TRACT-    0676     IN CHICAGO IL,"794","794","0","707","0","0",61.12
G17003100677,STCTY-17031 TRACT-    0677     IN CHICAGO IL,"1423","1423","0","1205","0","3286",52.13
G17003100678,STCTY-17031 TRACT-    0678     IN CHICAGO IL,"1781","1780","1","1473","1","3664",34.97
G17003100679,STCTY-17031 TRACT-    0679     IN CHICAGO IL,"2874","2874","0","2238","0","4206",38.75
G17003100680,STCTY-17031 TRACT-    0680     IN CHICAGO IL,"283","279","4","205","3","0",0
G17003100681,STCTY-17031 TRACT-    0681     IN CHICAGO IL,"958","425","533","326","533","2375",0
G17003100682,STCTY-17031 TRACT-    0682     IN CHICAGO IL,"832","832","0","703","0","0",41.82
G17003100683,STCTY-17031 TRACT-    0683     IN CHICAGO IL,"483","14","469","8","469","0",0
G17003100684,STCTY-17031 TRACT-    0684     IN CHICAGO IL,"19","19","0","15","0","0",0
G17003100685,STCTY-17031 TRACT-    0685     IN CHICAGO IL,"851","29","822","25","821","2299",0
G17003100686,STCTY-17031 TRACT-    0686     IN CHICAGO IL,"244","244","0","190","0","0",0
G17003100687,STCTY-17031 TRACT-    0687     IN CHICAGO IL,"3189","3189","0","2531","0","4722",42.94
G17003100688,STCTY-17031 TRACT-    0688     IN CHICAGO IL,"8697","8696","1","6430","1","3858",40.14
G17003100689,STCTY-17031 TRACT-    0689     IN CHICAGO IL,"5720","5718","2","4410","2","3909",41.06
G17003100690,STCTY-17031 TRACT-    0690     IN CHICAGO IL,"2823","2823","0","2159","0","4634",42.91
G17003100691,STCTY-17031 TRACT-    0691     IN CHICAGO IL,"9066","9065","1","6715","1","3742",34.79
G17003100692,STCTY-17031 TRACT-    0692     IN CHICAGO IL,"4664","4660","4","3576","1","3529",36.15
G17003100693,STCTY-17031 TRACT-    0693     IN CHICAGO IL,"2481","2481","0","2046","0","5980",47.42
G17003100694,STCTY-17031 TRACT-    0694     IN CHICAGO IL,"2676","2676","0","2228","0","4990",47
G17003100695,STCTY-17031 TRACT-    0695     IN CHICAGO IL,"1305","1305","0","1003","0","4907",42.43
G17003100696,STCTY-17031 TRACT-    0696     IN CHICAGO IL,"1","1","0","1","0","0",0
G17003100697,STCTY-17031 TRACT-    0697     IN CHICAGO IL,"379","379","0","342","0","0",0
G17003100698,STCTY-17031 TRACT-    0698     IN CHICAGO IL,"2259","2259","0","1648","0","2234",24.03
G17003100699,STCTY-17031 TRACT-    0699     IN CHICAGO IL,"3885","3883","2","2562","2","3031",26.38
G17003100700,STCTY-17031 TRACT-    0700     IN CHICAGO IL,"190","190","0","144","0","0",0
G17003100701,STCTY-17031 TRACT-    0701     IN CHICAGO IL,"4939","4939","0","3862","0","3241",29.04
G17003100702,STCTY-17031 TRACT-    0702     IN CHICAGO IL,"87","87","0","61","0","0",0
G17003100703,STCTY-17031 TRACT-    0703     IN CHICAGO IL,"3843","3843","0","2899","0","3285",33.18
G17003100704,STCTY-17031 TRACT-    0704     IN CHICAGO IL,"603","603","0","459","0","0",0
G17003100705,STCTY-17031 TRACT-    0705     IN CHICAGO IL,"2623","2622","1","2144","0","3880",35.76
G17003100706,STCTY-17031 TRACT-    0706     IN CHICAGO IL,"4711","4711","0","3644","0","2842",31.01
G17003100707,STCTY-17031 TRACT-    0707     IN CHICAGO IL,"4221","4221","0","3411","0","3096",31.18
G17003100708,STCTY-17031 TRACT-    0708     IN CHICAGO IL,"3769","3769","0","3115","0","4500",40.95
G17003100709,STCTY-17031 TRACT-    0709     IN CHICAGO IL,"691","691","0","598","0","0",0
G17003100710,STCTY-17031 TRACT-    0710     IN CHICAGO IL,"498","498","0","410","0","0",0
G17003100711,STCTY-17031 TRACT-    0711     IN CHICAGO IL,"1943","1935","8","1367","8","2491",23.13
G17003100712,STCTY-17031 TRACT-    0712     IN CHICAGO IL,"5051","4947","104","3414","94","2795",27.21
G17003100713,STCTY-17031 TRACT-    0713     IN CHICAGO IL,"2495","2495","0","1829","0","2341",28.96
G17003100714,STCTY-17031 TRACT-    0714     IN CHICAGO IL,"8534","8534","0","6495","0","3559",33.73
G17003100715,STCTY-17031 TRACT-    0715     IN CHICAGO IL,"9811","9808","3","7681","1","4381",35.6
G17003100716,STCTY-17031 TRACT-    0716     IN CHICAGO IL,"0","0","0","0","0","0",0
G17003100717,STCTY-17031 TRACT-    0717     IN CHICAGO IL,"1509","1503","6","1159","6","2893",26.81
G17003100718,STCTY-17031 TRACT-    0718     IN CHICAGO IL,"6654","6654","0","4956","0","2418",25.53
G17003100719,STCTY-17031 TRACT-    0719     IN CHICAGO IL,"855","855","0","686","0","3682",0
G17003100720,STCTY-17031 TRACT-    0720     IN CHICAGO IL,"163","163","0","117","0","0",0
G17003100721,STCTY-17031 TRACT-    0721     IN CHICAGO IL,"108","108","0","78","0","0",0
G17003100722,STCTY-17031 TRACT-    0722     IN CHICAGO IL,"14","14","0","8","0","0",0
G17003100723,STCTY-17031 TRACT-    0723     IN CHICAGO IL,"0","0","0","0","0","0",0
G17003100724,STCTY-17031 TRACT-    0724     IN CHICAGO IL,"7","7","0","7","0","0",0
G17003100725,STCTY-17031 TRACT-    0725     IN CHICAGO IL,"894","894","0","648","0","3321",0
G17003100726,STCTY-17031 TRACT-    0726     IN CHICAGO IL,"957","957","0","746","0","3300",0
G17003100727,STCTY-17031 TRACT-    0727     IN CHICAGO IL,"1922","1921","1","1560","1","3949",28.12
G17003100728,STCTY-17031 TRACT-    0728     IN CHICAGO IL,"634","634","0","456","0","0",0
G17003100729,STCTY-17031 TRACT-    0729     IN CHICAGO IL,"1573","1573","0","1198","0","3387",28.21
G17003100730,STCTY-17031 TRACT-    0730     IN CHICAGO IL,"5","5","0","5","0","0",0
G17003100731,STCTY-17031 TRACT-    0731     IN CHICAGO IL,"8","8","0","8","0","0",0
G17003100732,STCTY-17031 TRACT-    0732     IN CHICAGO IL,"526","526","0","373","0","0",0
G17003100733,STCTY-17031 TRACT-    0733     IN CHICAGO IL,"2","2","0","1","0","0",0
G17003100734,STCTY-17031 TRACT-    0734     IN CHICAGO IL,"535","535","0","391","0","0",0
G17003100735,STCTY-17031 TRACT-    0735     IN CHICAGO IL,"1688","1688","0","1286","0","3596",31.57
G17003100736,STCTY-17031 TRACT-    0736     IN CHICAGO IL,"546","546","0","378","0","0",0
G17003100737,STCTY-17031 TRACT-    0737     IN CHICAGO IL,"4341","4340","1","3169","1","4298",34.85
G17003100738,STCTY-17031 TRACT-    0738     IN CHICAGO IL,"1106","1106","0","818","0","3045",27.51
G17003100739,STCTY-17031 TRACT-    0739     IN CHICAGO IL,"3039","3039","0","2608","0","2428",31.97
G17003100740,STCTY-17031 TRACT-    0740     IN CHICAGO IL,"3538","3537","1","2799","0","2542",29.43
G17003100741,STCTY-17031 TRACT-    0741     IN CHICAGO IL,"2385","2385","0","1744","0","2073",26.79
G17003100742,STCTY-17031 TRACT-    0742     IN CHICAGO IL,"1709","1709","0","1382","0","3297",36.51
G17003100743,STCTY-17031 TRACT-    0743     IN CHICAGO IL,"2073","2073","0","1550","0","3657",34.99
G17003100744,STCTY-17031 TRACT-    0744     IN CHICAGO IL,"0","0","0","0","0","0",0
G17003100745,STCTY-17031 TRACT-    0745     IN CHICAGO IL,"11733","11733","0","8662","0","2643",33.05
G17003100746,STCTY-17031 TRACT-    0746     IN CHICAGO IL,"6426","6425","1","4657","1","2662",32.02
G17003100747,STCTY-17031 TRACT-    0747     IN CHICAGO IL,"5450","5450","0","3958","0","3102",31.89
G17003100748,STCTY-17031 TRACT-    0748     IN CHICAGO IL,"5542","5509","33","3947","33","2850",32.59
G17003100749,STCTY-17031 TRACT-    0749     IN CHICAGO IL,"2063","2063","0","1431","0","2368",28.83
G17003100750,STCTY-17031 TRACT-    0750     IN CHICAGO IL,"1065","1065","0","782","0","0",28.71
G17003100751,STCTY-17031 TRACT-    0751     IN CHICAGO IL,"7","7","0","4","0","0",0
G17003100752,STCTY-17031 TRACT-    0752     IN CHICAGO IL,"4289","4286","3","3646","0","2891",30.35
G17003100753,STCTY-17031 TRACT-    0753     IN CHICAGO IL,"451","451","0","386","0","0",0
G17003100754,STCTY-17031 TRACT-    0754     IN CHICAGO IL,"4378","4377","1","3439","1","2123",23.92
G17003100755,STCTY-17031 TRACT-    0755     IN CHICAGO IL,"5015","5015","0","4034","0","2423",26.54
G17003100756,STCTY-17031 TRACT-    0756     IN CHICAGO IL,"1533","1533","0","1290","0","3388",36.77
G17003100757,STCTY-17031 TRACT-    0757     IN CHICAGO IL,"748","746","2","623","0","0",31.07
G17003100758,STCTY-17031 TRACT-    0758     IN CHICAGO IL,"3225","3225","0","2678","0","2672",30.85
G17003100759,STCTY-17031 TRACT-    0759     IN CHICAGO IL,"790","790","0","683","0","0",27.6
G17003100760,STCTY-17031 TRACT-    0760     IN CHICAGO IL,"1275","1275","0","1002","0","0",21.34
G17003100761,STCTY-17031 TRACT-    0761     IN CHICAGO IL,"2172","2171","1","1713","0","1343",20.29
G17003100762,STCTY-17031 TRACT-    0762     IN CHICAGO IL,"2477","2476","1","2040","1","1831",25.12
G17003100763,STCTY-17031 TRACT-    0763     IN CHICAGO IL,"239","239","0","219","0","0",0
G17003100764,STCTY-17031 TRACT-    0764     IN CHICAGO IL,"863","863","0","711","0","0",21.79
G17003100765,STCTY-17031 TRACT-    0765     IN CHICAGO IL,"5461","5460","1","4221","1","2042",23
G17003100766,STCTY-17031 TRACT-    0766     IN CHICAGO IL,"234","233","1","187","1","0",0
G17003100767,STCTY-17031 TRACT-    0767     IN CHICAGO IL,"2311","2311","0","1872","0","1955",23.79
G17003100768,STCTY-17031 TRACT-    0768     IN CHICAGO IL,"4950","4950","0","4067","0","1817",22.22
G17003100769,STCTY-17031 TRACT-    0769     IN CHICAGO IL,"3829","3829","0","3187","0","1856",22.21
G17003100770,STCTY-17031 TRACT-    0770     IN CHICAGO IL,"5973","5971","2","4568","0","1829",23.26
G17003100771,STCTY-17031 TRACT-    0771     IN CHICAGO IL,"6137","6137","0","4441","0","1948",23.38
G17003100772,STCTY-17031 TRACT-    0772     IN CHICAGO IL,"665","665","0","440","0","0",21.59
G17003100773,STCTY-17031 TRACT-    0773     IN CHICAGO IL,"2709","2708","1","1945","1","1863",28.41
G17003100774,STCTY-17031 TRACT-    0774     IN CHICAGO IL,"500","500","0","394","0","0",0
G17003100775,STCTY-17031 TRACT-    0775     IN CHICAGO IL,"99","99","0","88","0","0",0
G17003100776,STCTY-17031 TRACT-    0776     IN CHICAGO IL,"555","555","0","454","0","0",23.8
G17003100777,STCTY-17031 TRACT-    0777     IN CHICAGO IL,"1223","1223","0","837","0","2339",30.4
G17003100778,STCTY-17031 TRACT-    0778     IN CHICAGO IL,"396","396","0","277","0","0",0
G17003100779,STCTY-17031 TRACT-    0779     IN CHICAGO IL,"1437","1435","2","1076","2","0",26.65
G17003100780,STCTY-17031 TRACT-    0780     IN CHICAGO IL,"4880","4878","2","3880","0","1865",24.81
G17003100781,STCTY-17031 TRACT-    0781     IN CHICAGO IL,"724","724","0","619","0","0",23.25
G17003100782,STCTY-17031 TRACT-    0782     IN CHICAGO IL,"7038","7037","1","5028","1","1271",21.11
G17003100783,STCTY-17031 TRACT-    0783     IN CHICAGO IL,"2974","2972","2","1916","0","1926",23.35
G17003100784,STCTY-17031 TRACT-    0784     IN CHICAGO IL,"32","32","0","21","0","0",0
G17003100785,STCTY-17031 TRACT-    0785     IN CHICAGO IL,"1140","1139","1","768","0","0",17.86
G17003100786,STCTY-17031 TRACT-    0786     IN CHICAGO IL,"0","0","0","0","0","0",0
G17003100787,STCTY-17031 TRACT-    0787     IN CHICAGO IL,"752","743","9","511","5","0",17.24
G17003100788,STCTY-17031 TRACT-    0788     IN CHICAGO IL,"437","437","0","328","0","0",0
G17003100789,STCTY-17031 TRACT-    0789     IN CHICAGO IL,"3216","3216","0","2438","0","1940",24.71
G17003100790,STCTY-17031 TRACT-    0790     IN CHICAGO IL,"4863","4857","6","3689","0","1750",25.34
G17003100791,STCTY-17031 TRACT-    0791     IN CHICAGO IL,"5181","5181","0","3974","0","1837",22.69
G17003100792,STCTY-17031 TRACT-    0792     IN CHICAGO IL,"5076","5076","0","3812","0","2077",25.75
G17003100793,STCTY-17031 TRACT-    0793     IN CHICAGO IL,"437","437","0","369","0","0",0
G17003100794,STCTY-17031 TRACT-    0794     IN CHICAGO IL,"1142","1142","0","1050","0","0",23.53
G17003100795,STCTY-17031 TRACT-    0795     IN CHICAGO IL,"310","309","1","276","1","0",0
G17003100796,STCTY-17031 TRACT-    0796     IN CHICAGO IL,"550","550","0","431","0","0",0
G17003100797,STCTY-17031 TRACT-    0797     IN CHICAGO IL,"4370","4365","5","3610","0","2015",26.04
G17003100798,STCTY-17031 TRACT-    0798     IN CHICAGO IL,"2785","2785","0","2420","0","1756",26.79
G17003100799,STCTY-17031 TRACT-    0799     IN CHICAGO IL,"5817","5817","0","4406","0","1713",21.3
G17003100800,STCTY-17031 TRACT-    0800     IN CHICAGO IL,"2317","2312","5","1850","0","2661",29.92
G17003100801,STCTY-17031 TRACT-    0801     IN CHICAGO IL,"2290","2290","0","1913","0","2039",27.45
G17003100802,STCTY-17031 TRACT-    0802     IN CHICAGO IL,"924","924","0","711","0","0",30.61
G17003100803,STCTY-17031 TRACT-    0803     IN CHICAGO IL,"4365","4365","0","3477","0","2609",32.82
G17003100804,STCTY-17031 TRACT-    0804     IN CHICAGO IL,"4491","4491","0","3676","0","2663",32.68
G17003100805,STCTY-17031 TRACT-    0805     IN CHICAGO IL,"3719","3659","60","3049","60","2019",31.88
G17003100806,STCTY-17031 TRACT-    0806     IN CHICAGO IL,"2292","2292","0","1734","0","2250",26.21
G17003100807,STCTY-17031 TRACT-    0807     IN CHICAGO IL,"4635","4635","0","3557","0","2155",27.73
G17003100808,STCTY-17031 TRACT-    0808     IN CHICAGO IL,"4472","4471","1","3478","1","2691",28.89
G17003100809,STCTY-17031 TRACT-    0809     IN CHICAGO IL,"5100","5100","0","3981","0","2424",28.41
G17003100810,STCTY-17031 TRACT-    0810     IN CHICAGO IL,"0","0","0","0","0","0",0
G17003100811,STCTY-17031 TRACT-    0811     IN CHICAGO IL,"224","224","0","144","0","0",0
G17003100812,STCTY-17031 TRACT-    0812     IN CHICAGO IL,"969","969","0","739","0","3900",0
G17003100813,STCTY-17031 TRACT-    0813     IN CHICAGO IL,"1595","1595","0","1204","0","2219",27.73
G17003100814,STCTY-17031 TRACT-    0814     IN CHICAGO IL,"467","467","0","349","0","0",0
G17003100815,STCTY-17031 TRACT-    0815     IN CHICAGO IL,"169","169","0","147","0","0",0
G17003100816,STCTY-17031 TRACT-    0816     IN CHICAGO IL,"960","959","1","703","0","0",28.5
G17003100817,STCTY-17031 TRACT-    0817     IN CHICAGO IL,"844","844","0","611","0","3206",34.5
G17003100818,STCTY-17031 TRACT-    0818     IN CHICAGO IL,"628","628","0","487","0","0",0
G17003100819,STCTY-17031 TRACT-    0819     IN CHICAGO IL,"3336","3336","0","2663","0","4690",40.73
G17003100820,STCTY-17031 TRACT-    0820     IN CHICAGO IL,"3884","3882","2","3315","0","5085",44.25
G17003100821,STCTY-17031 TRACT-    0821     IN CHICAGO IL,"5366","5366","0","3891","0","4500",34.95
G17003100822,STCTY-17031 TRACT-    0822     IN CHICAGO IL,"5251","5249","2","4302","0","5471",45.21
G17003100823,STCTY-17031 TRACT-    0823     IN CHICAGO IL,"4916","4916","0","3705","0","3954",34.14
G17003100824,STCTY-17031 TRACT-    0824     IN CHICAGO IL,"4313","4310","3","3493","1","5120",43.56
G17003100825,STCTY-17031 TRACT-    0825     IN CHICAGO IL,"286","286","0","245","0","0",0
G17003100826,STCTY-17031 TRACT-    0826     IN CHICAGO IL,"390","390","0","311","0","0",0
G17003100827,STCTY-17031 TRACT-    0827     IN CHICAGO IL,"130","130","0","96","0","0",0
G17003100828,STCTY-17031 TRACT-    0828     IN CHICAGO IL,"82","82","0","68","0","0",0
G17003100829,STCTY-17031 TRACT-    0829     IN CHICAGO IL,"2264","2264","0","1895","0","3895",35.95
G17003100830,STCTY-17031 TRACT-    0830     IN CHICAGO IL,"1152","1152","0","932","0","0",34.23
G17003100831,STCTY-17031 TRACT-    0831     IN CHICAGO IL,"700","700","0","578","0","0",0
G17003100832,STCTY-17031 TRACT-    0832     IN CHICAGO IL,"927","927","0","790","0","5729",45.06
G17003100833,STCTY-17031 TRACT-    0833     IN CHICAGO IL,"51","49","2","46","1","0",0
G17003100834,STCTY-17031 TRACT-    0834     IN CHICAGO IL,"762","756","6","656","5","0",30.91
G17003100835,STCTY-17031 TRACT-    0835     IN CHICAGO IL,"2955","2955","0","2369","0","4428",38.27
G17003100836,STCTY-17031 TRACT-    0836     IN CHICAGO IL,"3597","3596","1","2971","1","5179",38.37
G17003100837,STCTY-17031 TRACT-    0837     IN CHICAGO IL,"3105","3102","3","2629","3","4987",42.7
G17003100838,STCTY-17031 TRACT-    0838     IN CHICAGO IL,"632","631","1","550","1","5091",0
G17003100839,STCTY-17031 TRACT-    0839     IN CHICAGO IL,"4492","4489","3","3788","1","5067",42.31
G17003100840,STCTY-17031 TRACT-    0840     IN CHICAGO IL,"4091","4090","1","3562","1","5334",44.72
G17003100841,STCTY-17031 TRACT-    0841     IN CHICAGO IL,"6883","6883","0","5807","0","5853",45.69
G17003100842,STCTY-17031 TRACT-    0842     IN CHICAGO IL,"7528","7527","1","6353","0","5114",45.33
G17003100843,STCTY-17031 TRACT-    0843     IN CHICAGO IL,"6460","6460","0","5486","0","5403",46.37
G17003100844,STCTY-17031 TRACT-    0844     IN CHICAGO IL,"222","222","0","192","0","0",0
G17003100845,STCTY-17031 TRACT-    0845     IN CHICAGO IL,"2485","2485","0","2046","0","4400",40.54
G17003100846,STCTY-17031 TRACT-    0846     IN CHICAGO IL,"11632","11629","3","8903","3","4960",44.7
G17003100847,STCTY-17031 TRACT-    0847     IN CHICAGO IL,"5498","5497","1","4368","1","5105",43.58
G17003100848,STCTY-17031 TRACT-    0848     IN CHICAGO IL,"1541","1541","0","1345","0","3985",33.67
G17003100849,STCTY-17031 TRACT-    0849     IN CHICAGO IL,"247","247","0","217","0","0",0
G17003100850,STCTY-17031 TRACT-    0850     IN CHICAGO IL,"2441","2441","0","2014","0","3838",36.7
G17003100851,STCTY-17031 TRACT-    0851     IN CHICAGO IL,"4492","4490","2","3634","0","3392",38.48
G17003100852,STCTY-17031 TRACT-    0852     IN CHICAGO IL,"2968","2968","0","2391","0","3426",35.57
G17003100853,STCTY-17031 TRACT-    0853     IN CHICAGO IL,"2841","2841","0","2308","0","4109",43.05
G17003100854,STCTY-17031 TRACT-    0854     IN CHICAGO IL,"3409","3408","1","2710","1","3053",36.26
G17003100855,STCTY-17031 TRACT-    0855     IN CHICAGO IL,"3428","3425","3","2695","0","3575",37.28
G17003100856,STCTY-17031 TRACT-    0856     IN CHICAGO IL,"3025","3024","1","2717","0","3460",37.42
G17003100857,STCTY-17031 TRACT-    0857     IN CHICAGO IL,"3549","3548","1","2888","0","2837",36.24
G17003100858,STCTY-17031 TRACT-    0858     IN CHICAGO IL,"3411","3269","142","2634","138","3370",36.41
G17003100859,STCTY-17031 TRACT-    0859     IN CHICAGO IL,"2880","2877","3","2343","0","2736",37.58
G17003100860,STCTY-17031 TRACT-    0860     IN CHICAGO IL,"3336","3333","3","2732","1","3153",36.7
G17003100861,STCTY-17031 TRACT-    0861     IN CHICAGO IL,"3567","1228","2339","993","2339","2215",30.51
G17003100862,STCTY-17031 TRACT-    0862     IN CHICAGO IL,"787","787","0","662","0","0",44.65
G17003100863,STCTY-17031 TRACT-    0863     IN CHICAGO IL,"923","923","0","738","0","3629",0
G17003100864,STCTY-17031 TRACT-    0864     IN CHICAGO IL,"1008","1008","0","836","0","0",41.19
G17003100865,STCTY-17031 TRACT-    0865     IN CHICAGO IL,"5042","5042","0","3951","0","3461",34.01
G17003100866,STCTY-17031 TRACT-    0866     IN CHICAGO IL,"3817","3813","4","3070","0","4043",40.96
G17003100867,STCTY-17031 TRACT-    0867     IN CHICAGO IL,"3473","3471","2","2813","0","3420",36.22
G17003100868,STCTY-17031 TRACT-    0868     IN CHICAGO IL,"3596","3592","4","2927","0","3117",35.96
G17003100869,STCTY-17031 TRACT-    0869     IN CHICAGO IL,"1800","1800","0","1489","0","3908",38.2
G17003100870,STCTY-17031 TRACT-    0870     IN CHICAGO IL,"2590","2590","0","2073","0","3513",35.69
G17003100871,STCTY-17031 TRACT-    0871     IN CHICAGO IL,"4345","4343","2","3378","2","2682",35.99
G17003100872,STCTY-17031 TRACT-    0872     IN CHICAGO IL,"5160","3818","1342","2908","1342","1948",30.45
G17003100873,STCTY-17031 TRACT-    0873     IN CHICAGO IL,"4698","4691","7","3792","2","2985",38.67
G17003100874,STCTY-17031 TRACT-    0874     IN CHICAGO IL,"4743","4688","55","3665","53","2493",32.28
G17003100875,STCTY-17031 TRACT-    0875     IN CHICAGO IL,"3385","3385","0","2829","0","2593",35.1
G17003100876,STCTY-17031 TRACT-    0876     IN CHICAGO IL,"4142","4134","8","3295","8","2740",33.29
G17003100877,STCTY-17031 TRACT-    0877     IN CHICAGO IL,"13036","12635","401","10753","388","2750",29.39
G17003100878,STCTY-17031 TRACT-    0878     IN CHICAGO IL,"2050","2043","7","1709","7","2278",28.38
G17003100879,STCTY-17031 TRACT-    0879     IN CHICAGO IL,"8376","8368","8","7309","7","3704",39.46
G17003100880,STCTY-17031 TRACT-    0880     IN CHICAGO IL,"13861","13834","27","12324","14","3888",33.86
G17003100881,STCTY-17031 TRACT-    0881     IN CHICAGO IL,"9007","8837","170","7137","167","2878",38.31
G17003100882,STCTY-17031 TRACT-    0882     IN CHICAGO IL,"8561","8556","5","6923","1","3174",40.25
G17003100883,STCTY-17031 TRACT-    0883     IN CHICAGO IL,"6055","6047","8","4897","8","3475",35.3
G17003100884,STCTY-17031 TRACT-    0884     IN CHICAGO IL,"5430","5420","10","4652","9","4787",44.26
G17003100885,STCTY-17031 TRACT-    0885     IN CHICAGO IL,"6646","6644","2","5680","2","4324",43.55
G17003100886,STCTY-17031 TRACT-    0886     IN CHICAGO IL,"2658","2655","3","2259","3","4012",41.65
G17003100887,STCTY-17031 TRACT-    0887     IN CHICAGO IL,"1039","1026","13","878","13","0",41.75
G17003100888,STCTY-17031 TRACT-    0888     IN CHICAGO IL,"4194","4194","0","3637","0","5776",48.64
G17003100889,STCTY-17031 TRACT-    0889     IN CHICAGO IL,"7860","7854","6","6152","0","4048",44.26
G17003100890,STCTY-17031 TRACT-    0890     IN CHICAGO IL,"4691","4689","2","3840","2","3433",36.07
G17003100891,STCTY-17031 TRACT-    0891     IN CHICAGO IL,"449","439","10","382","10","0",0
G17003100892,STCTY-17031 TRACT-    0892     IN CHICAGO IL,"3670","3668","2","3075","2","6092",48.23
G17003100893,STCTY-17031 TRACT-    0893     IN CHICAGO IL,"6203","6193","10","4750","1","4812",44.23
G17003100894,STCTY-17031 TRACT-    0894     IN CHICAGO IL,"3986","3983","3","3145","1","3241",35.91
G17003100895,STCTY-17031 TRACT-    0895     IN CHICAGO IL,"1775","1653","122","1459","122","3380",30.1
G17003100896,STCTY-17031 TRACT-    0896     IN CHICAGO IL,"120","65","55","59","55","0",0
G17003100897,STCTY-17031 TRACT-    0897     IN CHICAGO IL,"681","659","22","556","22","0",26.08
G17003100898,STCTY-17031 TRACT-    0898     IN CHICAGO IL,"4919","4894","25","4297","25","3724",39.86
G17003100899,STCTY-17031 TRACT-    0899     IN CHICAGO IL,"8037","8025","12","7004","8","4735",41.93
G17003100900,STCTY-17031 TRACT-    0900     IN CHICAGO IL,"4626","4616","10","3989","10","4677",42.72
G17003100901,STCTY-17031 TRACT-    0901     IN CHICAGO IL,"10","10","0","8","0","0",0
G17003100902,STCTY-17031 TRACT-    0902     IN CHICAGO IL,"721","721","0","627","0","0",0
G17003100903,STCTY-17031 TRACT-    0903     IN CHICAGO IL,"6124","6123","1","5275","1","5688",47.42
G17003100904,STCTY-17031 TRACT-    0904     IN CHICAGO IL,"5283","5283","0","4568","0","6056",50.66
G17003100905,STCTY-17031 TRACT-    0905     IN CHICAGO IL,"5421","5419","2","4836","2","6930",51.13
G17003100906,STCTY-17031 TRACT-    0906     IN CHICAGO IL,"2555","2554","1","2195","0","6443",47.27
G17003100907,STCTY-17031 TRACT-    0907     IN CHICAGO IL,"1976","1976","0","1690","0","5966",44.84
G17003100908,STCTY-17031 TRACT-    0908     IN CHICAGO IL,"2433","2430","3","2130","0","4610",41.51
G17003100909,STCTY-17031 TRACT-    0909     IN CHICAGO IL,"2431","2430","1","2022","1","3345",34.85
G17003100910,STCTY-17031 TRACT-    0910     IN CHICAGO IL,"2022","2022","0","1734","0","4795",38.67
G17003100911,STCTY-17031 TRACT-    0911     IN CHICAGO IL,"2951","2945","6","2567","1","5857",48.39
G17003100912,STCTY-17031 TRACT-    0912     IN CHICAGO IL,"21128","21126","2","18097","2","5791",48.41
G17003100913,STCTY-17031 TRACT-    0913     IN CHICAGO IL,"3600","3600","0","3117","0","6688",48.27
G17003100914,STCTY-17031 TRACT-    0914     IN CHICAGO IL,"1369","1363","6","1133","6","5704",44.57
G17003100915,STCTY-17031 TRACT-    0915     IN CHICAGO IL,"2749","2720","29","2494","28","13051",77.13
G17003100916,STCTY-17031 TRACT-    0916     IN CHICAGO IL,"3261","3253","8","3034","8","11525",81.93
G17003100917,STCTY-17031 TRACT-    0917     IN CHICAGO IL,"4438","4416","22","4042","21","7891",56.28
G17003100918,STCTY-17031 TRACT-    0918     IN CHICAGO IL,"1581","1578","3","1481","3","14167",0
G17003100919,STCTY-17031 TRACT-    0919     IN CHICAGO IL,"3179","3173","6","2918","6","7509",56.49
G17003100920,STCTY-17031 TRACT-    0920     IN CHICAGO IL,"19","19","0","15","0","0",0
G17003100921,STCTY-17031 TRACT-    0921     IN CHICAGO IL,"683","682","1","608","1","8387",0
G17003100922,STCTY-17031 TRACT-    0922     IN CHICAGO IL,"1170","1170","0","1037","0","6130",0
G17003100923,STCTY-17031 TRACT-    0923     IN CHICAGO IL,"6281","6232","49","5384","49","5284",43.87
G17003100924,STCTY-17031 TRACT-    0924     IN CHICAGO IL,"2476","2476","0","2134","0","4807",37.39
G17003100925,STCTY-17031 TRACT-    0925     IN CHICAGO IL,"260","260","0","207","0","0",0
G17003100926,STCTY-17031 TRACT-    0926     IN CHICAGO IL,"7274","7274","0","6515","0","6691",59.31
G17003100927,STCTY-17031 TRACT-    0927     IN CHICAGO IL,"1909","1907","2","1630","0","4747",40.4
G17003100928,STCTY-17031 TRACT-    0928     IN CHICAGO IL,"1610","1610","0","1372","0","2958",32.59
G17003100929,STCTY-17031 TRACT-    0929     IN CHICAGO IL,"2780","2779","1","2236","0","3528",31.31
G17003100930,STCTY-17031 TRACT-    0930     IN CHICAGO IL,"618","618","0","536","0","0",0
G17003100931,STCTY-17031 TRACT-    0931     IN CHICAGO IL,"529","528","1","447","1","0",0
G17003100932,STCTY-17031 TRACT-    0932     IN CHICAGO IL,"3371","3307","64","3028","60","8228",64.4
G17003100933,STCTY-17031 TRACT-    0933     IN CHICAGO IL,"5806","4638","1168","4188","1165","6014",48.46
G17003100934,STCTY-17031 TRACT-    0934     IN CHICAGO IL,"2459","207","2252","176","2252","3325",32.2
G17003100935,STCTY-17031 TRACT-    0935     IN CHICAGO IL,"2862","153","2709","117","2707","3681",28.38
